//MAP CONVERTED BY dmm2tgm.py THIS HEADER COMMENT PREVENTS RECONVERSION, DO NOT REMOVE
"a" = (
/obj/effect/mapping_helpers/no_lava,
/turf/closed/mineral/ash_rock,
/area/lavaland/surface/outdoors)
"b" = (
/turf/closed/mineral/ash_rock,
/area/ruin/powered/errorhostile)
"d" = (
/obj/effect/mapping_helpers/no_lava,
/turf/open/floor/plating/asteroid/basalt,
/area/lavaland/surface/outdoors)
"e" = (
/obj/structure/stone_tile/surrounding/cracked,
/turf/open/floor/plating/asteroid/basalt,
/area/ruin/powered/errorhostile)
"g" = (
/obj/structure/stone_tile/surrounding/cracked{
	dir = 4
	},
/turf/open/floor/plating/asteroid/basalt,
/area/ruin/powered/errorhostile)
"h" = (
/obj/structure/stone_tile/slab/cracked,
/turf/open/floor/plating/asteroid/basalt,
/area/ruin/powered/errorhostile)
"i" = (
/obj/structure/stone_tile/center/burnt,
/turf/open/floor/plating/asteroid/basalt,
/area/ruin/powered/errorhostile)
"l" = (
/obj/structure/stone_tile/slab/burnt,
/turf/open/floor/plating/asteroid/basalt,
/area/ruin/powered/errorhostile)
"m" = (
/obj/structure/stone_tile/surrounding,
/turf/open/floor/plating/asteroid/basalt,
/area/ruin/powered/errorhostile)
"n" = (
/turf/open/floor/plasteel/cult,
/area/ruin/powered/errorhostile)
"o" = (
/obj/structure/stone_tile/center/cracked,
/turf/open/floor/plating/asteroid/basalt,
/area/ruin/powered/errorhostile)
"p" = (
/turf/closed/indestructible/necropolis,
/area/ruin/powered/errorhostile)
"q" = (
/obj/structure/stone_tile/surrounding/burnt,
/turf/open/floor/plating/asteroid/basalt,
/area/ruin/powered/errorhostile)
"r" = (
/obj/structure/stone_tile/slab,
/obj/structure/stone_tile/slab,
/turf/open/floor/plating/asteroid/basalt,
/area/ruin/powered/errorhostile)
"s" = (
/obj/structure/stone_tile/center,
/turf/open/floor/plating/asteroid/basalt,
/area/ruin/powered/errorhostile)
"t" = (
/obj/structure/stone_tile/surrounding/cracked{
	dir = 1
	},
/turf/open/floor/plating/asteroid/basalt,
/area/ruin/powered/errorhostile)
"u" = (
/obj/structure/stone_tile/block{
	dir = 1
	},
/turf/open/floor/plating/asteroid/basalt,
/area/ruin/powered/errorhostile)
"v" = (
/turf/open/lava/smooth,
/area/ruin/powered/errorhostile)
"w" = (
/obj/structure/stone_tile/surrounding_tile/burnt{
	dir = 8
	},
/turf/open/floor/plating/asteroid/basalt,
/area/ruin/powered/errorhostile)
"x" = (
/obj/structure/stone_tile/surrounding/cracked{
	dir = 8
	},
/turf/open/floor/plating/asteroid/basalt,
/area/ruin/powered/errorhostile)
"y" = (
/obj/structure/stone_tile/surrounding_tile,
/turf/open/floor/plating/asteroid/basalt,
/area/ruin/powered/errorhostile)
"z" = (
/obj/structure/stone_tile/burnt{
	dir = 8
	},
/turf/open/floor/plating/asteroid/basalt,
/area/ruin/powered/errorhostile)
"B" = (
/obj/structure/stone_tile/burnt,
/turf/open/floor/plating/asteroid/basalt,
/area/ruin/powered/errorhostile)
"C" = (
/obj/structure/stone_tile/block/burnt{
	dir = 1
	},
/turf/open/floor/plating/asteroid/basalt,
/area/ruin/powered/errorhostile)
"E" = (
/mob/living/simple_animal/hostile/megafauna/wendigo,
/turf/open/floor/plating/asteroid/basalt,
/area/ruin/powered/errorhostile)
"F" = (
/obj/structure/stone_tile{
	dir = 8
	},
/turf/open/floor/plating/asteroid/basalt,
/area/ruin/powered/errorhostile)
"G" = (
/obj/structure/stone_tile,
/turf/open/floor/plating/asteroid/basalt,
/area/ruin/powered/errorhostile)
"H" = (
/obj/structure/stone_tile/slab,
/obj/item/paper/crumpled{
	info = "i should have never touched it. i am but a fool...";
	name = "regret"
	},
/turf/open/floor/plating/asteroid/basalt,
/area/ruin/powered/errorhostile)
"I" = (
/obj/structure/stone_tile/block/cracked{
	dir = 1
	},
/turf/open/floor/plating/asteroid/basalt,
/area/ruin/powered/errorhostile)
"J" = (
/obj/effect/temp_visual/lava_warning,
/turf/open/floor/plating/asteroid/basalt,
/area/ruin/powered/errorhostile)
"K" = (
/obj/structure/necropolis_arch,
/obj/structure/stone_tile/slab,
/turf/open/floor/plating/asteroid/basalt,
/area/ruin/powered/errorhostile)
"L" = (
/obj/structure/stone_tile/block,
/obj/structure/stone_tile/block,
/turf/open/floor/plating/asteroid/basalt,
/area/ruin/powered/errorhostile)
"N" = (
/obj/effect/mapping_helpers/no_lava,
/obj/effect/mapping_helpers/no_lava,
/turf/closed/mineral/ash_rock,
/area/lavaland/surface/outdoors)
"O" = (
/turf/open/floor/plating/asteroid/basalt,
/area/ruin/powered/errorhostile)
"P" = (
/obj/effect/decal/cleanable/blood/old,
/obj/item/bodypart/head/devil,
/turf/open/floor/plating/asteroid/basalt,
/area/ruin/powered/errorhostile)
"Q" = (
/obj/structure/stone_tile/slab,
/turf/open/floor/plating/asteroid/basalt,
/area/ruin/powered/errorhostile)
"R" = (
/obj/effect/decal/cleanable/blood/gibs,
/turf/open/floor/plating/asteroid/basalt,
/area/ruin/powered/errorhostile)
"S" = (
/turf/template_noop,
/area/template_noop)
"T" = (
/obj/effect/decal/cleanable/blood/gibs,
/obj/item/kinetic_crusher,
/turf/open/floor/plating/asteroid/basalt,
/area/ruin/powered/errorhostile)
"U" = (
/obj/effect/mapping_helpers/no_lava,
/turf/open/floor/plating/asteroid/basalt,
/area/ruin/powered/errorhostile)
"V" = (
/obj/structure/necropolis_gate,
/obj/structure/stone_tile/slab/cracked,
/turf/open/floor/plating/asteroid/basalt,
/area/ruin/powered/errorhostile)
"W" = (
/turf/open/chasm/lavaland,
/area/ruin/powered/errorhostile)
"X" = (
/obj/item/gps/mining{
	gpstag = "_errorcode-hostile_"
	},
/turf/open/floor/plating/asteroid/basalt,
/area/ruin/powered/errorhostile)
"Z" = (
/obj/structure/mineral_door/sandstone,
/turf/open/floor/holofloor/basalt,
/area/ruin/powered/errorhostile)

(1,1,1) = {"
S
S
S
S
S
S
S
S
S
S
S
S
S
S
S
S
S
S
S
S
S
S
S
S
S
S
S
S
S
S
S
S
S
S
S
S
S
S
S
S
S
S
S
S
S
S
S
S
S
S
S
S
S
S
S
S
S
"}
(2,1,1) = {"
S
S
S
S
S
S
S
S
S
S
S
S
S
S
S
S
S
S
S
S
S
S
S
S
S
S
S
S
S
S
S
S
S
S
S
S
S
S
S
S
S
S
S
S
S
S
S
S
S
S
S
S
S
S
S
S
S
"}
(3,1,1) = {"
S
S
S
S
S
S
S
S
S
S
S
S
S
S
S
S
S
S
S
a
a
a
a
a
a
a
a
a
a
a
a
S
S
S
S
S
S
S
S
S
S
S
S
S
S
S
S
S
S
S
S
S
S
S
S
S
S
"}
(4,1,1) = {"
S
S
S
S
S
S
S
S
S
S
S
S
S
S
a
a
a
a
a
p
p
p
p
p
p
p
p
p
p
p
p
a
a
a
a
a
S
S
S
S
S
S
S
S
S
S
S
S
S
S
S
S
S
S
S
S
S
"}
(5,1,1) = {"
S
S
S
S
S
S
S
S
S
S
S
a
a
a
p
p
p
p
p
v
v
Q
v
v
v
v
v
v
v
v
v
p
p
p
p
p
a
a
a
S
S
S
S
S
S
S
S
S
S
S
S
S
S
S
S
S
S
"}
(6,1,1) = {"
S
S
S
S
S
S
S
S
S
a
a
p
p
p
v
v
v
v
v
O
O
Q
Q
O
O
O
O
O
O
O
O
v
v
v
v
v
p
p
p
a
a
S
S
S
S
S
S
S
S
S
S
S
S
S
S
S
S
"}
(7,1,1) = {"
S
S
S
S
S
S
S
S
a
p
p
v
v
v
O
O
O
O
O
O
O
Q
Q
O
O
O
O
O
O
O
O
O
O
O
O
O
v
v
v
p
p
a
S
S
S
S
S
S
S
S
S
S
S
S
S
S
S
"}
(8,1,1) = {"
S
S
S
S
S
S
S
a
p
v
v
O
O
O
O
O
O
O
O
O
Q
O
h
O
O
O
O
O
O
O
O
O
O
O
O
O
O
O
O
v
v
p
a
S
S
S
S
S
S
S
S
S
S
S
S
S
S
"}
(9,1,1) = {"
S
S
S
S
S
S
a
p
v
O
O
O
O
O
O
O
O
O
O
O
s
O
Q
O
O
O
O
O
O
O
O
O
O
O
O
O
O
O
O
O
O
v
p
a
S
S
S
S
S
S
S
S
S
S
S
S
S
"}
(10,1,1) = {"
S
S
S
S
S
a
p
v
O
O
O
O
O
O
O
O
O
O
O
O
s
O
O
Q
O
O
O
O
O
O
O
O
O
O
O
O
O
O
O
O
O
O
v
p
a
S
S
S
S
S
S
S
S
S
S
S
S
"}
(11,1,1) = {"
S
S
S
S
a
p
v
O
O
O
O
O
O
O
O
O
O
O
O
O
l
O
O
Q
O
O
O
O
O
O
O
O
O
O
O
O
O
O
O
O
O
O
O
v
p
a
S
S
S
S
S
S
S
S
S
S
S
"}
(12,1,1) = {"
S
S
S
S
a
p
v
O
O
O
O
O
O
O
O
O
O
O
O
O
o
O
O
O
h
O
O
O
O
O
O
O
O
O
O
O
O
O
O
O
O
O
O
v
p
a
S
S
S
S
S
S
S
S
S
S
S
"}
(13,1,1) = {"
S
S
S
S
a
p
v
O
O
O
O
O
O
O
O
O
Q
h
Q
O
Q
O
O
O
Q
O
Q
Q
g
O
O
O
O
O
O
O
O
O
O
O
Q
o
o
Q
p
a
S
S
S
S
S
S
S
S
S
S
S
"}
(14,1,1) = {"
S
S
S
a
p
v
O
O
O
O
O
O
O
O
Q
m
O
O
O
O
Q
O
O
O
h
O
O
O
O
Q
Q
O
O
O
O
O
O
O
Q
l
O
O
O
Q
v
p
a
S
S
S
S
S
S
S
S
S
S
"}
(15,1,1) = {"
S
S
S
a
p
v
O
O
O
O
O
O
q
Q
O
O
O
O
O
O
Q
O
O
O
O
Q
O
O
O
O
O
Q
O
O
O
Q
h
Q
O
O
O
O
Q
O
v
p
a
S
S
S
S
S
S
S
S
S
S
"}
(16,1,1) = {"
S
S
S
a
p
v
O
O
O
O
O
Q
O
O
O
O
O
O
O
Q
O
O
O
O
O
Q
O
O
O
O
O
O
O
r
o
O
O
O
O
O
O
O
o
O
v
p
a
S
S
S
S
S
S
S
S
S
S
"}
(17,1,1) = {"
S
S
S
a
p
v
O
O
O
O
O
Q
O
O
O
O
O
O
O
o
O
O
O
O
O
O
Q
O
O
q
Q
o
i
O
O
O
O
O
O
O
O
h
O
O
v
p
a
S
S
S
S
S
S
S
S
S
S
"}
(18,1,1) = {"
S
S
a
p
v
O
O
O
O
O
Q
O
O
O
O
O
O
O
O
l
O
O
O
O
O
O
l
Q
Q
O
O
O
O
O
O
O
O
O
O
O
l
O
O
O
O
v
p
a
S
S
S
S
S
S
S
S
S
"}
(19,1,1) = {"
S
S
a
p
v
O
O
O
O
O
m
O
O
O
O
O
O
O
O
Q
O
O
O
O
O
O
Q
O
O
O
O
O
O
O
O
O
O
O
O
Q
O
O
O
O
O
v
p
a
S
S
S
S
S
S
S
S
S
"}
(20,1,1) = {"
S
S
a
p
v
O
O
O
O
g
O
O
O
O
O
O
O
O
O
Q
O
O
O
O
O
O
Q
O
O
O
O
O
O
O
O
O
O
O
O
o
O
O
O
O
O
v
p
a
S
S
S
S
S
S
S
S
S
"}
(21,1,1) = {"
S
S
a
p
v
O
O
O
O
Q
O
O
O
O
O
O
O
O
O
h
O
O
O
O
O
O
O
Q
O
O
O
O
O
O
O
O
O
O
Q
O
O
O
O
O
O
v
p
N
a
a
a
S
S
S
S
S
S
"}
(22,1,1) = {"
S
S
a
p
v
O
O
O
O
h
O
O
O
O
O
O
O
Q
Q
O
O
O
O
O
O
O
O
o
O
O
O
O
O
O
O
O
O
o
O
O
O
O
O
O
O
v
p
b
b
b
b
a
a
S
S
S
S
"}
(23,1,1) = {"
S
S
a
p
v
O
O
O
O
Q
O
O
O
O
Q
q
l
O
O
O
O
O
O
n
O
O
O
Q
Q
l
l
o
Q
O
O
O
Q
O
O
O
O
O
O
O
O
J
b
O
O
b
W
b
b
a
a
S
S
"}
(24,1,1) = {"
S
S
a
p
v
O
O
O
O
h
O
O
h
Q
O
O
O
O
O
O
O
n
n
n
n
n
O
h
O
O
O
O
O
Q
l
o
O
O
O
O
O
O
O
O
O
O
b
O
O
b
O
W
W
b
b
a
d
"}
(25,1,1) = {"
S
S
a
p
v
O
O
O
O
Q
i
Q
O
O
O
O
O
O
O
O
n
Q
Q
Q
Q
Q
n
Q
O
O
O
O
O
O
O
O
Q
Q
o
o
O
O
O
O
O
O
b
O
O
b
O
O
O
W
W
b
d
"}
(26,1,1) = {"
S
S
a
p
v
O
O
Q
l
O
O
O
O
O
O
O
O
O
O
n
Q
Q
Q
Q
Q
Q
Q
n
O
O
O
O
O
O
O
O
O
O
O
O
Q
H
Q
O
O
O
p
O
z
b
X
O
O
O
O
b
d
"}
(27,1,1) = {"
S
S
a
p
v
Q
Q
O
O
O
O
O
O
O
O
O
O
O
n
Q
Q
Q
t
O
g
Q
r
Q
n
O
O
O
O
O
w
O
F
O
z
O
F
O
z
O
z
O
O
F
h
O
O
O
O
O
O
b
U
"}
(28,1,1) = {"
S
S
a
p
Q
O
O
O
O
O
O
O
O
O
O
O
O
n
n
Q
Q
Q
O
E
O
Q
Q
Q
n
n
O
O
O
O
e
u
l
u
l
C
Q
I
h
u
Q
C
K
L
Q
V
O
O
O
O
O
Z
U
"}
(29,1,1) = {"
S
S
a
p
v
Q
l
O
O
O
O
O
O
O
O
O
O
O
n
Q
Q
Q
x
O
e
Q
Q
Q
n
O
O
O
O
O
y
O
G
O
B
O
G
O
B
O
B
O
O
G
h
O
O
O
O
O
O
b
U
"}
(30,1,1) = {"
S
S
a
p
v
O
O
e
Q
O
O
O
O
O
O
O
O
O
O
n
Q
Q
Q
Q
Q
Q
Q
n
O
O
O
O
O
O
O
O
O
O
O
O
Q
q
Q
O
O
O
p
O
B
b
O
O
O
O
O
b
d
"}
(31,1,1) = {"
S
S
a
p
v
O
O
O
O
l
O
Q
O
O
O
O
O
O
O
O
n
Q
Q
Q
Q
Q
n
Q
O
O
O
O
O
O
O
O
Q
o
O
Q
O
O
O
O
O
O
b
R
O
b
O
O
O
W
W
b
d
"}
(32,1,1) = {"
S
S
a
p
v
O
O
O
O
O
O
O
Q
o
O
O
O
O
O
O
O
n
n
n
n
n
O
l
O
O
O
O
O
Q
q
Q
O
O
O
O
O
O
O
O
O
O
b
P
T
b
O
W
W
b
b
a
d
"}
(33,1,1) = {"
S
S
a
p
v
O
O
O
O
Q
O
O
O
O
Q
Q
o
O
O
O
O
O
O
n
O
O
O
o
Q
e
O
O
Q
O
O
O
Q
O
O
O
O
O
O
O
O
J
b
O
R
b
W
b
b
a
a
S
S
"}
(34,1,1) = {"
S
S
a
p
v
O
O
O
O
O
O
O
O
O
O
O
O
q
Q
O
O
O
O
O
O
O
O
Q
O
O
O
O
O
O
O
O
O
Q
O
O
O
O
O
O
O
v
p
b
b
b
b
a
a
S
S
S
S
"}
(35,1,1) = {"
S
S
a
p
v
O
O
O
O
i
O
O
O
O
O
O
O
O
O
o
O
O
O
O
O
O
O
Q
O
O
O
O
O
O
O
O
O
O
o
O
O
O
O
O
O
v
p
a
a
a
a
S
S
S
S
S
S
"}
(36,1,1) = {"
S
S
a
p
v
O
O
O
O
Q
O
O
O
O
O
O
O
O
O
Q
O
O
O
O
O
O
h
O
O
O
O
O
O
O
O
O
O
O
O
Q
O
O
O
O
O
v
p
a
S
S
S
S
S
S
S
S
S
"}
(37,1,1) = {"
S
S
a
p
v
O
O
O
O
O
Q
O
O
O
O
O
O
O
O
r
O
O
O
O
O
O
o
O
O
O
O
O
O
O
O
O
O
O
O
h
O
O
O
O
O
v
p
a
S
S
S
S
S
S
S
S
S
"}
(38,1,1) = {"
S
S
S
a
p
v
O
O
O
O
Q
O
O
O
O
O
O
O
O
o
O
O
O
O
O
O
o
Q
Q
O
O
O
O
O
O
O
O
O
O
O
Q
O
O
O
O
v
p
a
S
S
S
S
S
S
S
S
S
"}
(39,1,1) = {"
S
S
S
a
p
v
O
O
O
O
O
o
O
O
O
O
O
O
O
Q
O
O
O
O
O
O
Q
O
O
Q
Q
h
Q
O
O
O
O
O
O
O
O
l
O
O
v
p
a
S
S
S
S
S
S
S
S
S
S
"}
(40,1,1) = {"
S
S
S
a
p
v
O
O
O
O
O
Q
O
O
O
O
O
O
O
Q
O
O
O
O
O
Q
O
O
O
O
O
O
O
Q
Q
O
O
O
O
O
O
O
Q
O
v
p
a
S
S
S
S
S
S
S
S
S
S
"}
(41,1,1) = {"
S
S
S
a
p
v
O
O
O
O
O
O
h
e
O
O
O
O
O
O
Q
O
O
O
O
Q
O
O
O
O
O
Q
O
O
O
Q
i
Q
O
O
O
O
Q
O
v
p
a
S
S
S
S
S
S
S
S
S
S
"}
(42,1,1) = {"
S
S
S
a
p
v
O
O
O
O
O
O
O
O
Q
o
O
O
O
O
o
O
O
O
Q
O
O
O
O
Q
q
O
O
O
O
O
O
O
Q
h
O
O
O
Q
v
p
a
S
S
S
S
S
S
S
S
S
S
"}
(43,1,1) = {"
S
S
S
S
a
p
v
O
O
O
O
O
O
O
O
O
Q
o
Q
O
t
O
O
O
o
O
Q
Q
h
O
O
O
O
O
O
O
O
O
O
O
Q
O
o
Q
p
a
S
S
S
S
S
S
S
S
S
S
S
"}
(44,1,1) = {"
S
S
S
S
a
p
v
O
O
O
O
O
O
O
O
O
O
O
O
O
o
O
O
O
Q
O
O
O
O
O
O
O
O
O
O
O
O
O
O
O
O
O
O
v
p
a
S
S
S
S
S
S
S
S
S
S
S
"}
(45,1,1) = {"
S
S
S
S
a
p
v
O
O
O
O
O
O
O
O
O
O
O
O
O
o
O
O
Q
O
O
O
O
O
O
O
O
O
O
O
O
O
O
O
O
O
O
O
v
p
a
S
S
S
S
S
S
S
S
S
S
S
"}
(46,1,1) = {"
S
S
S
S
S
a
p
v
O
O
O
O
O
O
O
O
O
O
O
O
Q
O
O
Q
O
O
O
O
O
O
O
O
O
O
O
O
O
O
O
O
O
O
v
p
a
S
S
S
S
S
S
S
S
S
S
S
S
"}
(47,1,1) = {"
S
S
S
S
S
S
a
p
v
O
O
O
O
O
O
O
O
O
O
O
h
O
Q
O
O
O
O
O
O
O
O
O
O
O
O
O
O
O
O
O
O
v
p
a
S
S
S
S
S
S
S
S
S
S
S
S
S
"}
(48,1,1) = {"
S
S
S
S
S
S
S
a
p
v
v
O
O
O
O
O
O
O
O
O
h
O
o
O
O
O
O
O
O
O
O
O
O
O
O
O
O
O
O
v
v
p
a
S
S
S
S
S
S
S
S
S
S
S
S
S
S
"}
(49,1,1) = {"
S
S
S
S
S
S
S
S
a
p
p
v
v
v
O
O
O
O
O
O
O
Q
o
O
O
O
O
O
O
O
O
O
O
O
O
O
v
v
v
p
p
a
S
S
S
S
S
S
S
S
S
S
S
S
S
S
S
"}
(50,1,1) = {"
S
S
S
S
S
S
S
S
S
a
a
p
p
p
v
v
v
v
v
O
O
h
Q
O
O
O
O
O
O
O
O
v
v
v
v
v
p
p
p
a
a
S
S
S
S
S
S
S
S
S
S
S
S
S
S
S
S
"}
(51,1,1) = {"
S
S
S
S
S
S
S
S
S
S
S
a
a
a
p
p
p
p
p
v
v
Q
v
v
v
v
v
v
v
v
v
p
p
p
p
p
a
a
a
S
S
S
S
S
S
S
S
S
S
S
S
S
S
S
S
S
S
"}
(52,1,1) = {"
S
S
S
S
S
S
S
S
S
S
S
S
S
S
a
a
a
a
a
p
p
p
p
p
p
p
p
p
p
p
p
a
a
a
a
a
S
S
S
S
S
S
S
S
S
S
S
S
S
S
S
S
S
S
S
S
S
"}
(53,1,1) = {"
S
S
S
S
S
S
S
S
S
S
S
S
S
S
S
S
S
S
S
a
a
a
a
a
a
a
a
a
a
a
a
S
S
S
S
S
S
S
S
S
S
S
S
S
S
S
S
S
S
S
S
S
S
S
S
S
S
"}
(54,1,1) = {"
S
S
S
S
S
S
S
S
S
S
S
S
S
S
S
S
S
S
S
S
S
S
S
S
S
S
S
S
S
S
S
S
S
S
S
S
S
S
S
S
S
S
S
S
S
S
S
S
S
S
S
S
S
S
S
S
S
"}
(55,1,1) = {"
S
S
S
S
S
S
S
S
S
S
S
S
S
S
S
S
S
S
S
S
S
S
S
S
S
S
S
S
S
S
S
S
S
S
S
S
S
S
S
S
S
S
S
S
S
S
S
S
S
S
S
S
S
S
S
S
S
"}
