//MAP CONVERTED BY dmm2tgm.py THIS HEADER COMMENT PREVENTS RECONVERSION, DO NOT REMOVE
"az" = (
/obj/structure/stone_tile/burnt{
	dir = 8
	},
/turf/open/indestructible/necropolis/air,
/area/ruin/lavaland/powered)
"aV" = (
/obj/structure/stone_tile/slab,
/obj/structure/stone_tile/slab,
/turf/open/floor/plating/asteroid/basalt,
/area/ruin/lavaland/powered)
"eN" = (
/mob/living/simple_animal/hostile/megafauna/wendigo,
/turf/open/indestructible/necropolis/air,
/area/ruin/lavaland/powered)
"fc" = (
/obj/structure/stone_tile/center,
/turf/open/indestructible/necropolis/air,
/area/ruin/lavaland/powered)
"gU" = (
/obj/structure/stone_tile/surrounding,
/turf/open/indestructible/necropolis/air,
/area/ruin/lavaland/powered)
"hc" = (
/obj/effect/decal/cleanable/blood/gibs,
/obj/item/kinetic_crusher,
/turf/open/floor/plating/asteroid/basalt,
/area/ruin/lavaland/powered)
"jg" = (
/obj/structure/stone_tile/center/burnt,
/turf/open/indestructible/necropolis/air,
/area/ruin/lavaland/powered)
"jS" = (
/obj/structure/stone_tile/surrounding_tile,
/turf/open/indestructible/necropolis/air,
/area/ruin/lavaland/powered)
"kg" = (
/obj/structure/stone_tile/surrounding/cracked{
	dir = 1
	},
/turf/open/indestructible/necropolis/air,
/area/ruin/lavaland/powered)
"kE" = (
/obj/effect/mapping_helpers/no_lava,
/turf/open/floor/plating/asteroid/basalt,
/area/lavaland/surface/outdoors)
"li" = (
/obj/structure/stone_tile/surrounding/cracked,
/turf/open/indestructible/necropolis/air,
/area/ruin/lavaland/powered)
"lG" = (
/obj/structure/stone_tile/center/cracked,
/turf/open/floor/plating/asteroid/basalt,
/area/ruin/lavaland/powered)
"nM" = (
/obj/structure/stone_tile/slab/cracked,
/turf/open/indestructible/necropolis/air,
/area/ruin/lavaland/powered)
"on" = (
/obj/structure/stone_tile/burnt{
	dir = 8
	},
/turf/open/floor/plating/asteroid/basalt,
/area/ruin/lavaland/powered)
"ov" = (
/obj/effect/decal/cleanable/blood/gibs,
/turf/open/floor/plating/asteroid/basalt,
/area/ruin/lavaland/powered)
"pK" = (
/obj/effect/decal/cleanable/blood/old,
/obj/item/bodypart/head/devil,
/turf/open/floor/plating/asteroid/basalt,
/area/ruin/lavaland/powered)
"qm" = (
/turf/open/floor/plating/asteroid/basalt,
/area/ruin/lavaland/powered)
"rr" = (
/obj/effect/mapping_helpers/no_lava,
/turf/open/floor/plating/asteroid/basalt,
/area/ruin/lavaland/powered)
"rv" = (
/turf/open/chasm/lavaland,
/area/ruin/lavaland/powered)
"sZ" = (
/obj/structure/stone_tile,
/turf/open/floor/plating/asteroid/basalt,
/area/ruin/lavaland/powered)
"uf" = (
/obj/structure/stone_tile/slab/cracked,
/turf/open/floor/plating/asteroid/basalt,
/area/ruin/lavaland/powered)
"vA" = (
/obj/effect/mapping_helpers/no_lava,
/obj/effect/mapping_helpers/no_lava,
/turf/closed/mineral/ash_rock,
/area/lavaland/surface/outdoors)
"xN" = (
/obj/structure/mineral_door/sandstone,
/turf/open/floor/holofloor/basalt,
/area/ruin/lavaland/powered)
"zn" = (
/turf/template_noop,
/area/template_noop)
"Aj" = (
/obj/structure/stone_tile/slab/burnt,
/turf/open/floor/plating/asteroid/basalt,
/area/ruin/lavaland/powered)
"Ar" = (
/turf/closed/indestructible/necropolis,
/area/ruin/lavaland/powered)
"By" = (
/obj/structure/necropolis_arch,
/obj/structure/stone_tile/slab,
/turf/open/floor/plating/asteroid/basalt,
/area/ruin/lavaland/powered)
"CZ" = (
/obj/structure/stone_tile/block/burnt{
	dir = 1
	},
/turf/open/indestructible/necropolis/air,
/area/ruin/lavaland/powered)
"Dw" = (
/obj/structure/stone_tile/surrounding/cracked{
	dir = 8
	},
/turf/open/indestructible/necropolis/air,
/area/ruin/lavaland/powered)
"DZ" = (
/obj/structure/stone_tile/block/cracked{
	dir = 1
	},
/turf/open/indestructible/necropolis/air,
/area/ruin/lavaland/powered)
"Gw" = (
/obj/structure/stone_tile/block,
/obj/structure/stone_tile/block,
/turf/open/floor/plating/asteroid/basalt,
/area/ruin/lavaland/powered)
"IS" = (
/obj/item/gps/mining{
	gpstag = "_errorcode-hostile_"
	},
/turf/open/floor/plating/asteroid/basalt,
/area/ruin/lavaland/powered)
"Ks" = (
/obj/structure/stone_tile/block/burnt{
	dir = 1
	},
/turf/open/floor/plating/asteroid/basalt,
/area/ruin/lavaland/powered)
"Ku" = (
/obj/structure/stone_tile,
/turf/open/indestructible/necropolis/air,
/area/ruin/lavaland/powered)
"Lm" = (
/obj/structure/stone_tile/surrounding_tile/burnt{
	dir = 8
	},
/turf/open/indestructible/necropolis/air,
/area/ruin/lavaland/powered)
"Nl" = (
/obj/structure/stone_tile/block{
	dir = 1
	},
/turf/open/indestructible/necropolis/air,
/area/ruin/lavaland/powered)
"No" = (
/obj/structure/stone_tile{
	dir = 8
	},
/turf/open/indestructible/necropolis/air,
/area/ruin/lavaland/powered)
"Qm" = (
/turf/open/lava/smooth,
/area/ruin/lavaland/powered)
"QB" = (
/turf/open/floor/plasteel/cult,
/area/ruin/lavaland/powered)
"QY" = (
/obj/structure/stone_tile{
	dir = 8
	},
/turf/open/floor/plating/asteroid/basalt,
/area/ruin/lavaland/powered)
"Uq" = (
/obj/structure/stone_tile/slab,
/turf/open/indestructible/necropolis/air,
/area/ruin/lavaland/powered)
"Vt" = (
/obj/structure/necropolis_gate,
/obj/structure/stone_tile/slab/cracked,
/turf/open/floor/plating/asteroid/basalt,
/area/ruin/lavaland/powered)
"Wi" = (
/turf/closed/mineral/ash_rock,
/area/ruin/lavaland/powered)
"Ww" = (
/obj/structure/stone_tile/surrounding/burnt,
/turf/open/indestructible/necropolis/air,
/area/ruin/lavaland/powered)
"Xk" = (
/obj/structure/stone_tile/slab,
/obj/item/paper/crumpled{
	info = "i should have never touched it. i am but a fool...";
	name = "regret"
	},
/turf/open/floor/plating/asteroid/basalt,
/area/ruin/lavaland/powered)
"Xp" = (
/turf/open/indestructible/necropolis/air,
/area/ruin/lavaland/powered)
"XA" = (
/obj/structure/stone_tile/surrounding/cracked{
	dir = 4
	},
/turf/open/indestructible/necropolis/air,
/area/ruin/lavaland/powered)
"XC" = (
/obj/structure/stone_tile/center/cracked,
/turf/open/indestructible/necropolis/air,
/area/ruin/lavaland/powered)
"XQ" = (
/obj/structure/stone_tile/slab,
/turf/open/floor/plating/asteroid/basalt,
/area/ruin/lavaland/powered)
"Yg" = (
/obj/effect/mapping_helpers/no_lava,
/turf/closed/mineral/ash_rock,
/area/lavaland/surface/outdoors)
"YQ" = (
/obj/effect/temp_visual/lava_warning,
/turf/open/floor/plating/asteroid/basalt,
/area/ruin/lavaland/powered)
"Zj" = (
/obj/structure/stone_tile/burnt,
/turf/open/indestructible/necropolis/air,
/area/ruin/lavaland/powered)
"Zs" = (
/obj/structure/stone_tile/burnt,
/turf/open/floor/plating/asteroid/basalt,
/area/ruin/lavaland/powered)

(1,1,1) = {"
zn
zn
zn
zn
zn
zn
zn
zn
zn
zn
zn
zn
zn
zn
zn
zn
zn
zn
zn
zn
zn
zn
zn
zn
zn
zn
zn
zn
zn
zn
zn
zn
zn
zn
zn
zn
zn
zn
zn
zn
zn
zn
zn
zn
zn
zn
zn
zn
zn
zn
zn
zn
zn
zn
zn
zn
zn
"}
(2,1,1) = {"
zn
zn
zn
zn
zn
zn
zn
zn
zn
zn
zn
zn
zn
zn
zn
zn
zn
zn
zn
zn
zn
zn
zn
zn
zn
zn
zn
zn
zn
zn
zn
zn
zn
zn
zn
zn
zn
zn
zn
zn
zn
zn
zn
zn
zn
zn
zn
zn
zn
zn
zn
zn
zn
zn
zn
zn
zn
"}
(3,1,1) = {"
zn
zn
zn
zn
zn
zn
zn
zn
zn
zn
zn
zn
zn
zn
zn
zn
zn
zn
zn
Yg
Yg
Yg
Yg
Yg
Yg
Yg
Yg
Yg
Yg
Yg
Yg
zn
zn
zn
zn
zn
zn
zn
zn
zn
zn
zn
zn
zn
zn
zn
zn
zn
zn
zn
zn
zn
zn
zn
zn
zn
zn
"}
(4,1,1) = {"
zn
zn
zn
zn
zn
zn
zn
zn
zn
zn
zn
zn
zn
zn
Yg
Yg
Yg
Yg
Yg
Ar
Ar
Ar
Ar
Ar
Ar
Ar
Ar
Ar
Ar
Ar
Ar
Yg
Yg
Yg
Yg
Yg
zn
zn
zn
zn
zn
zn
zn
zn
zn
zn
zn
zn
zn
zn
zn
zn
zn
zn
zn
zn
zn
"}
(5,1,1) = {"
zn
zn
zn
zn
zn
zn
zn
zn
zn
zn
zn
Yg
Yg
Yg
Ar
Ar
Ar
Ar
Ar
Qm
Qm
XQ
Qm
Qm
Qm
Qm
Qm
Qm
Qm
Qm
Qm
Ar
Ar
Ar
Ar
Ar
Yg
Yg
Yg
zn
zn
zn
zn
zn
zn
zn
zn
zn
zn
zn
zn
zn
zn
zn
zn
zn
zn
"}
(6,1,1) = {"
zn
zn
zn
zn
zn
zn
zn
zn
zn
Yg
Yg
Ar
Ar
Ar
Qm
Qm
Qm
Qm
Qm
qm
qm
XQ
XQ
qm
qm
qm
qm
qm
qm
qm
qm
Qm
Qm
Qm
Qm
Qm
Ar
Ar
Ar
Yg
Yg
zn
zn
zn
zn
zn
zn
zn
zn
zn
zn
zn
zn
zn
zn
zn
zn
"}
(7,1,1) = {"
zn
zn
zn
zn
zn
zn
zn
zn
Yg
Ar
Ar
Qm
Qm
Qm
qm
qm
qm
qm
qm
qm
qm
XQ
XQ
qm
qm
qm
qm
qm
qm
qm
qm
qm
qm
qm
qm
qm
Qm
Qm
Qm
Ar
Ar
Yg
zn
zn
zn
zn
zn
zn
zn
zn
zn
zn
zn
zn
zn
zn
zn
"}
(8,1,1) = {"
zn
zn
zn
zn
zn
zn
zn
Yg
Ar
Qm
Qm
qm
qm
qm
qm
qm
qm
qm
qm
qm
XQ
Xp
nM
qm
qm
qm
qm
qm
qm
qm
qm
qm
qm
qm
qm
qm
qm
qm
qm
Qm
Qm
Ar
Yg
zn
zn
zn
zn
zn
zn
zn
zn
zn
zn
zn
zn
zn
zn
"}
(9,1,1) = {"
zn
zn
zn
zn
zn
zn
Yg
Ar
Qm
qm
qm
qm
qm
qm
qm
qm
qm
qm
qm
qm
fc
Xp
XQ
qm
qm
qm
qm
qm
qm
qm
qm
qm
qm
qm
qm
qm
qm
qm
qm
qm
qm
Qm
Ar
Yg
zn
zn
zn
zn
zn
zn
zn
zn
zn
zn
zn
zn
zn
"}
(10,1,1) = {"
zn
zn
zn
zn
zn
Yg
Ar
Qm
qm
qm
qm
qm
qm
qm
qm
qm
qm
qm
qm
qm
fc
Xp
Xp
XQ
qm
qm
qm
qm
qm
qm
qm
qm
qm
qm
qm
qm
qm
qm
qm
qm
qm
qm
Qm
Ar
Yg
zn
zn
zn
zn
zn
zn
zn
zn
zn
zn
zn
zn
"}
(11,1,1) = {"
zn
zn
zn
zn
Yg
Ar
Qm
qm
qm
qm
qm
qm
qm
qm
qm
qm
qm
qm
qm
qm
Aj
Xp
Xp
XQ
qm
qm
qm
qm
qm
qm
qm
qm
qm
qm
qm
qm
qm
qm
qm
qm
qm
qm
qm
Qm
Ar
Yg
zn
zn
zn
zn
zn
zn
zn
zn
zn
zn
zn
"}
(12,1,1) = {"
zn
zn
zn
zn
Yg
Ar
Qm
qm
qm
qm
qm
qm
qm
qm
qm
qm
Xp
Xp
Xp
Xp
XC
Xp
Xp
Xp
nM
Xp
Xp
Xp
Xp
qm
qm
qm
qm
qm
qm
qm
qm
qm
qm
qm
qm
qm
qm
Qm
Ar
Yg
zn
zn
zn
zn
zn
zn
zn
zn
zn
zn
zn
"}
(13,1,1) = {"
zn
zn
zn
zn
Yg
Ar
Qm
qm
qm
qm
qm
qm
qm
qm
Xp
Xp
XQ
nM
XQ
qm
XQ
Xp
Xp
Xp
XQ
XC
XQ
XQ
XA
Xp
Xp
qm
qm
qm
qm
qm
qm
qm
qm
qm
XQ
XC
XC
XQ
Ar
Yg
zn
zn
zn
zn
zn
zn
zn
zn
zn
zn
zn
"}
(14,1,1) = {"
zn
zn
zn
Yg
Ar
Qm
qm
qm
qm
qm
qm
qm
Xp
Xp
XQ
gU
qm
qm
qm
qm
XQ
Xp
Xp
Xp
nM
qm
qm
qm
qm
XQ
XQ
Xp
qm
qm
qm
qm
qm
qm
XQ
Aj
Xp
Xp
Xp
XQ
Qm
Ar
Yg
zn
zn
zn
zn
zn
zn
zn
zn
zn
zn
"}
(15,1,1) = {"
zn
zn
zn
Yg
Ar
Qm
qm
qm
qm
qm
qm
Xp
Ww
XQ
qm
qm
qm
qm
qm
qm
XQ
Xp
Xp
Xp
Xp
XQ
qm
qm
qm
qm
qm
XQ
Xp
qm
qm
XQ
nM
XQ
Xp
Xp
Xp
Xp
XQ
qm
Qm
Ar
Yg
zn
zn
zn
zn
zn
zn
zn
zn
zn
zn
"}
(16,1,1) = {"
zn
zn
zn
Yg
Ar
Qm
qm
qm
qm
qm
Xp
XQ
qm
qm
qm
qm
qm
qm
qm
XQ
Xp
Xp
Xp
Xp
Xp
XQ
qm
qm
qm
qm
qm
qm
Xp
aV
XC
Xp
Xp
Xp
Xp
Xp
Xp
Xp
XC
qm
Qm
Ar
Yg
zn
zn
zn
zn
zn
zn
zn
zn
zn
zn
"}
(17,1,1) = {"
zn
zn
zn
Yg
Ar
Qm
qm
qm
qm
qm
Xp
XQ
qm
qm
qm
qm
qm
qm
qm
XC
Xp
Xp
Xp
Xp
Xp
Xp
XQ
qm
qm
Ww
XQ
XC
jg
Xp
Xp
Xp
Xp
Xp
Xp
Xp
Xp
nM
qm
qm
Qm
Ar
Yg
zn
zn
zn
zn
zn
zn
zn
zn
zn
zn
"}
(18,1,1) = {"
zn
zn
Yg
Ar
Qm
qm
qm
qm
qm
Xp
XQ
qm
qm
qm
qm
qm
qm
qm
qm
Aj
Xp
Xp
Xp
Xp
Xp
Xp
Aj
XQ
XQ
Xp
Xp
Xp
Xp
Xp
Xp
Xp
Xp
Xp
Xp
Xp
Aj
qm
qm
qm
qm
Qm
Ar
Yg
zn
zn
zn
zn
zn
zn
zn
zn
zn
"}
(19,1,1) = {"
zn
zn
Yg
Ar
Qm
qm
qm
qm
qm
Xp
gU
qm
qm
qm
qm
qm
qm
qm
qm
XQ
Xp
Xp
Xp
Xp
Xp
Xp
XQ
Xp
Xp
Xp
Xp
Xp
Xp
Xp
Xp
Xp
Xp
Xp
Xp
XQ
qm
qm
qm
qm
qm
Qm
Ar
Yg
zn
zn
zn
zn
zn
zn
zn
zn
zn
"}
(20,1,1) = {"
zn
zn
Yg
Ar
Qm
qm
qm
qm
Xp
XA
qm
qm
qm
qm
qm
qm
qm
qm
qm
XQ
Xp
Xp
Xp
Xp
Xp
Xp
XQ
Xp
Xp
Xp
Xp
Xp
Xp
Xp
Xp
Xp
Xp
Xp
Xp
XC
qm
qm
qm
qm
qm
Qm
Ar
Yg
zn
zn
zn
zn
zn
zn
zn
zn
zn
"}
(21,1,1) = {"
zn
zn
Yg
Ar
Qm
qm
qm
qm
Xp
XQ
qm
qm
qm
qm
qm
qm
qm
qm
qm
uf
Xp
Xp
Xp
Xp
Xp
Xp
Xp
XQ
Xp
Xp
Xp
Xp
Xp
Xp
Xp
Xp
Xp
Xp
XQ
qm
qm
qm
qm
qm
qm
Qm
Ar
vA
Yg
Yg
Yg
zn
zn
zn
zn
zn
zn
"}
(22,1,1) = {"
zn
zn
Yg
Ar
Qm
qm
qm
qm
Xp
nM
qm
qm
qm
qm
qm
qm
qm
XQ
XQ
Xp
Xp
Xp
Xp
Xp
Xp
Xp
Xp
XC
Xp
Xp
Xp
Xp
Xp
Xp
Xp
Xp
Xp
XC
qm
qm
qm
qm
qm
qm
qm
Qm
Ar
Wi
Wi
Wi
Wi
Yg
Yg
zn
zn
zn
zn
"}
(23,1,1) = {"
zn
zn
Yg
Ar
Qm
qm
qm
qm
Xp
XQ
qm
qm
qm
qm
XQ
Ww
Aj
Xp
Xp
Xp
Xp
Xp
Xp
QB
Xp
Xp
Xp
XQ
XQ
Aj
Aj
XC
XQ
Xp
Xp
Xp
XQ
qm
qm
qm
qm
qm
qm
qm
qm
YQ
Wi
qm
qm
Wi
rv
Wi
Wi
Yg
Yg
zn
zn
"}
(24,1,1) = {"
zn
zn
Yg
Ar
Qm
qm
qm
qm
Xp
nM
qm
qm
nM
XQ
Xp
Xp
Xp
Xp
Xp
Xp
Xp
QB
QB
QB
QB
QB
Xp
nM
Xp
Xp
Xp
Xp
Xp
XQ
Aj
XC
qm
qm
qm
qm
qm
qm
qm
qm
qm
qm
Wi
qm
qm
Wi
qm
rv
rv
Wi
Wi
Yg
kE
"}
(25,1,1) = {"
zn
zn
Yg
Ar
Qm
qm
qm
qm
Xp
XQ
jg
XQ
Xp
Xp
Xp
Xp
Xp
Xp
Xp
Xp
QB
XQ
XQ
XQ
XQ
XQ
QB
XQ
Xp
Xp
Xp
Xp
Xp
Xp
Xp
Xp
XQ
XQ
XC
XC
qm
qm
qm
qm
qm
qm
Wi
qm
qm
Wi
qm
qm
qm
rv
rv
Wi
kE
"}
(26,1,1) = {"
zn
zn
Yg
Ar
Qm
qm
qm
XQ
Aj
Xp
Xp
Xp
Xp
Xp
Xp
Xp
Xp
Xp
Xp
QB
XQ
XQ
XQ
XQ
XQ
XQ
XQ
QB
Xp
Xp
Xp
Xp
Xp
Xp
Xp
Xp
Xp
Xp
Xp
Xp
XQ
Xk
XQ
qm
qm
qm
Ar
qm
on
Wi
IS
qm
qm
qm
qm
Wi
kE
"}
(27,1,1) = {"
zn
zn
Yg
Ar
Qm
XQ
XQ
Xp
Xp
Xp
Xp
Xp
Xp
Xp
Xp
Xp
Xp
Xp
QB
XQ
XQ
XQ
kg
Xp
XA
XQ
aV
XQ
QB
Xp
Xp
Xp
Xp
Xp
Lm
Xp
No
Xp
az
Xp
No
Xp
az
XQ
on
qm
qm
QY
uf
qm
qm
qm
qm
qm
qm
Wi
rr
"}
(28,1,1) = {"
zn
zn
Yg
Ar
XQ
Xp
Xp
Xp
Xp
Xp
Xp
Xp
Xp
Xp
Xp
Xp
Xp
QB
QB
XQ
XQ
XQ
Xp
eN
Xp
XQ
XQ
XQ
QB
QB
Xp
Xp
Xp
Xp
li
Nl
Aj
Nl
Aj
CZ
XQ
DZ
nM
Nl
XQ
Ks
By
Gw
XQ
Vt
qm
qm
qm
qm
qm
xN
rr
"}
(29,1,1) = {"
zn
zn
Yg
Ar
Qm
XQ
Aj
Xp
Xp
Xp
Xp
Xp
Xp
Xp
Xp
Xp
Xp
Xp
QB
XQ
XQ
XQ
Dw
Xp
li
XQ
XQ
XQ
QB
Xp
Xp
Xp
Xp
Xp
jS
Xp
Ku
Xp
Zj
Xp
Ku
Xp
Zj
XQ
Zs
qm
qm
sZ
uf
qm
qm
qm
qm
qm
qm
Wi
rr
"}
(30,1,1) = {"
zn
zn
Yg
Ar
Qm
qm
qm
li
XQ
Xp
Xp
Xp
Xp
Xp
Xp
Xp
Xp
Xp
Xp
QB
XQ
XQ
XQ
XQ
XQ
XQ
XQ
QB
Xp
Xp
Xp
Xp
Xp
Xp
Xp
Xp
Xp
Xp
Xp
Xp
XQ
Ww
XQ
qm
qm
qm
Ar
qm
Zs
Wi
qm
qm
qm
qm
qm
Wi
kE
"}
(31,1,1) = {"
zn
zn
Yg
Ar
Qm
qm
qm
qm
Xp
Aj
qm
XQ
Xp
Xp
Xp
Xp
Xp
Xp
Xp
Xp
QB
XQ
XQ
XQ
XQ
XQ
QB
XQ
Xp
Xp
Xp
Xp
Xp
Xp
Xp
Xp
XQ
XC
Xp
XQ
qm
qm
qm
qm
qm
qm
Wi
ov
qm
Wi
qm
qm
qm
rv
rv
Wi
kE
"}
(32,1,1) = {"
zn
zn
Yg
Ar
Qm
qm
qm
qm
Xp
Uq
qm
qm
XQ
XC
Xp
Xp
Xp
Xp
Xp
Xp
Xp
QB
QB
QB
QB
QB
Xp
Aj
Xp
Xp
Xp
Xp
Xp
XQ
Ww
XQ
qm
qm
qm
qm
qm
qm
qm
qm
qm
qm
Wi
pK
hc
Wi
qm
rv
rv
Wi
Wi
Yg
kE
"}
(33,1,1) = {"
zn
zn
Yg
Ar
Qm
qm
qm
qm
Xp
XQ
qm
qm
qm
qm
XQ
XQ
XC
Xp
Xp
Xp
Xp
Xp
Xp
QB
Xp
Xp
Xp
XC
XQ
li
Xp
Xp
XQ
Xp
Xp
Xp
XQ
qm
qm
qm
qm
qm
qm
qm
qm
YQ
Wi
qm
ov
Wi
rv
Wi
Wi
Yg
Yg
zn
zn
"}
(34,1,1) = {"
zn
zn
Yg
Ar
Qm
qm
qm
qm
Xp
Uq
qm
qm
qm
qm
qm
qm
qm
Ww
XQ
Xp
Xp
Xp
Xp
Xp
Xp
Xp
Xp
XQ
Xp
Xp
Xp
Xp
Xp
Xp
Xp
Xp
Xp
XQ
qm
qm
qm
qm
qm
qm
qm
Qm
Ar
Wi
Wi
Wi
Wi
Yg
Yg
zn
zn
zn
zn
"}
(35,1,1) = {"
zn
zn
Yg
Ar
Qm
qm
qm
qm
Xp
jg
qm
qm
qm
qm
qm
qm
qm
qm
qm
XC
Xp
Xp
Xp
Xp
Xp
Xp
Xp
XQ
Xp
Xp
Xp
Xp
Xp
Xp
Xp
Xp
Xp
Xp
XC
qm
qm
qm
qm
qm
qm
Qm
Ar
Yg
Yg
Yg
Yg
zn
zn
zn
zn
zn
zn
"}
(36,1,1) = {"
zn
zn
Yg
Ar
Qm
qm
qm
qm
Xp
XQ
qm
qm
qm
qm
qm
qm
qm
qm
qm
XQ
Xp
Xp
Xp
Xp
Xp
Xp
nM
Xp
Xp
Xp
Xp
Xp
Xp
Xp
Xp
Xp
Xp
Xp
Xp
XQ
qm
qm
qm
qm
qm
Qm
Ar
Yg
zn
zn
zn
zn
zn
zn
zn
zn
zn
"}
(37,1,1) = {"
zn
zn
Yg
Ar
Qm
qm
qm
qm
qm
Xp
XQ
qm
qm
qm
qm
qm
qm
qm
qm
aV
Xp
Xp
Xp
Xp
Xp
Xp
XC
Xp
Xp
Xp
Xp
Xp
Xp
Xp
Xp
Xp
Xp
Xp
Xp
nM
qm
qm
qm
qm
qm
Qm
Ar
Yg
zn
zn
zn
zn
zn
zn
zn
zn
zn
"}
(38,1,1) = {"
zn
zn
zn
Yg
Ar
Qm
qm
qm
qm
Xp
XQ
qm
qm
qm
qm
qm
qm
qm
qm
lG
Xp
Xp
Xp
Xp
Xp
Xp
XC
XQ
XQ
Xp
Xp
Xp
Xp
Xp
Xp
Xp
Xp
Xp
Xp
Xp
XQ
qm
qm
qm
qm
Qm
Ar
Yg
zn
zn
zn
zn
zn
zn
zn
zn
zn
"}
(39,1,1) = {"
zn
zn
zn
Yg
Ar
Qm
qm
qm
qm
qm
Xp
XC
qm
qm
qm
qm
qm
qm
qm
XQ
Xp
Xp
Xp
Xp
Xp
Xp
XQ
qm
qm
XQ
XQ
nM
XQ
Xp
Xp
Xp
Xp
Xp
Xp
Xp
Xp
Aj
qm
qm
Qm
Ar
Yg
zn
zn
zn
zn
zn
zn
zn
zn
zn
zn
"}
(40,1,1) = {"
zn
zn
zn
Yg
Ar
Qm
qm
qm
qm
qm
Xp
XQ
qm
qm
qm
qm
qm
qm
qm
XQ
Xp
Xp
Xp
Xp
Xp
XQ
qm
qm
qm
qm
qm
XC
Xp
XQ
XQ
Xp
Xp
Xp
Xp
Xp
Xp
Xp
XQ
qm
Qm
Ar
Yg
zn
zn
zn
zn
zn
zn
zn
zn
zn
zn
"}
(41,1,1) = {"
zn
zn
zn
Yg
Ar
Qm
qm
qm
qm
qm
qm
Xp
nM
li
qm
qm
qm
qm
qm
qm
XQ
Xp
Xp
Xp
Xp
XQ
qm
qm
qm
qm
qm
XQ
Xp
qm
qm
XQ
jg
XQ
Xp
Xp
Xp
Xp
XQ
qm
Qm
Ar
Yg
zn
zn
zn
zn
zn
zn
zn
zn
zn
zn
"}
(42,1,1) = {"
zn
zn
zn
Yg
Ar
Qm
qm
qm
qm
qm
qm
qm
Xp
Xp
XQ
XC
qm
qm
qm
qm
XC
Xp
Xp
Xp
XQ
qm
qm
qm
qm
XQ
Ww
Xp
qm
qm
qm
qm
qm
qm
XQ
nM
Xp
Xp
Xp
XQ
Qm
Ar
Yg
zn
zn
zn
zn
zn
zn
zn
zn
zn
zn
"}
(43,1,1) = {"
zn
zn
zn
zn
Yg
Ar
Qm
qm
qm
qm
qm
qm
qm
Xp
Xp
Xp
XQ
XC
XQ
Uq
kg
Xp
Xp
Xp
XC
Xp
XQ
XQ
nM
Xp
Xp
qm
qm
qm
qm
qm
qm
qm
qm
qm
XQ
Xp
XC
XQ
Ar
Yg
zn
zn
zn
zn
zn
zn
zn
zn
zn
zn
zn
"}
(44,1,1) = {"
zn
zn
zn
zn
Yg
Ar
Qm
qm
qm
qm
qm
qm
qm
qm
qm
Xp
Xp
Xp
Xp
Xp
XC
Xp
Xp
Xp
XQ
Xp
Xp
Xp
Xp
qm
qm
qm
qm
qm
qm
qm
qm
qm
qm
qm
qm
qm
qm
Qm
Ar
Yg
zn
zn
zn
zn
zn
zn
zn
zn
zn
zn
zn
"}
(45,1,1) = {"
zn
zn
zn
zn
Yg
Ar
Qm
qm
qm
qm
qm
qm
qm
qm
qm
qm
qm
qm
qm
qm
XC
Xp
Xp
XQ
qm
qm
qm
qm
qm
qm
qm
qm
qm
qm
qm
qm
qm
qm
qm
qm
qm
qm
qm
Qm
Ar
Yg
zn
zn
zn
zn
zn
zn
zn
zn
zn
zn
zn
"}
(46,1,1) = {"
zn
zn
zn
zn
zn
Yg
Ar
Qm
qm
qm
qm
qm
qm
qm
qm
qm
qm
qm
qm
qm
XQ
Xp
Xp
XQ
qm
qm
qm
qm
qm
qm
qm
qm
qm
qm
qm
qm
qm
qm
qm
qm
qm
qm
Qm
Ar
Yg
zn
zn
zn
zn
zn
zn
zn
zn
zn
zn
zn
zn
"}
(47,1,1) = {"
zn
zn
zn
zn
zn
zn
Yg
Ar
Qm
qm
qm
qm
qm
qm
qm
qm
qm
qm
qm
qm
nM
Xp
XQ
qm
qm
qm
qm
qm
qm
qm
qm
qm
qm
qm
qm
qm
qm
qm
qm
qm
qm
Qm
Ar
Yg
zn
zn
zn
zn
zn
zn
zn
zn
zn
zn
zn
zn
zn
"}
(48,1,1) = {"
zn
zn
zn
zn
zn
zn
zn
Yg
Ar
Qm
Qm
qm
qm
qm
qm
qm
qm
qm
qm
qm
nM
Xp
XC
qm
qm
qm
qm
qm
qm
qm
qm
qm
qm
qm
qm
qm
qm
qm
qm
Qm
Qm
Ar
Yg
zn
zn
zn
zn
zn
zn
zn
zn
zn
zn
zn
zn
zn
zn
"}
(49,1,1) = {"
zn
zn
zn
zn
zn
zn
zn
zn
Yg
Ar
Ar
Qm
Qm
Qm
qm
qm
qm
qm
qm
qm
qm
XQ
XC
qm
qm
qm
qm
qm
qm
qm
qm
qm
qm
qm
qm
qm
Qm
Qm
Qm
Ar
Ar
Yg
zn
zn
zn
zn
zn
zn
zn
zn
zn
zn
zn
zn
zn
zn
zn
"}
(50,1,1) = {"
zn
zn
zn
zn
zn
zn
zn
zn
zn
Yg
Yg
Ar
Ar
Ar
Qm
Qm
Qm
Qm
Qm
qm
qm
nM
XQ
qm
qm
qm
qm
qm
qm
qm
qm
Qm
Qm
Qm
Qm
Qm
Ar
Ar
Ar
Yg
Yg
zn
zn
zn
zn
zn
zn
zn
zn
zn
zn
zn
zn
zn
zn
zn
zn
"}
(51,1,1) = {"
zn
zn
zn
zn
zn
zn
zn
zn
zn
zn
zn
Yg
Yg
Yg
Ar
Ar
Ar
Ar
Ar
Qm
Qm
XQ
Qm
Qm
Qm
Qm
Qm
Qm
Qm
Qm
Qm
Ar
Ar
Ar
Ar
Ar
Yg
Yg
Yg
zn
zn
zn
zn
zn
zn
zn
zn
zn
zn
zn
zn
zn
zn
zn
zn
zn
zn
"}
(52,1,1) = {"
zn
zn
zn
zn
zn
zn
zn
zn
zn
zn
zn
zn
zn
zn
Yg
Yg
Yg
Yg
Yg
Ar
Ar
Ar
Ar
Ar
Ar
Ar
Ar
Ar
Ar
Ar
Ar
Yg
Yg
Yg
Yg
Yg
zn
zn
zn
zn
zn
zn
zn
zn
zn
zn
zn
zn
zn
zn
zn
zn
zn
zn
zn
zn
zn
"}
(53,1,1) = {"
zn
zn
zn
zn
zn
zn
zn
zn
zn
zn
zn
zn
zn
zn
zn
zn
zn
zn
zn
Yg
Yg
Yg
Yg
Yg
Yg
Yg
Yg
Yg
Yg
Yg
Yg
zn
zn
zn
zn
zn
zn
zn
zn
zn
zn
zn
zn
zn
zn
zn
zn
zn
zn
zn
zn
zn
zn
zn
zn
zn
zn
"}
(54,1,1) = {"
zn
zn
zn
zn
zn
zn
zn
zn
zn
zn
zn
zn
zn
zn
zn
zn
zn
zn
zn
zn
zn
zn
zn
zn
zn
zn
zn
zn
zn
zn
zn
zn
zn
zn
zn
zn
zn
zn
zn
zn
zn
zn
zn
zn
zn
zn
zn
zn
zn
zn
zn
zn
zn
zn
zn
zn
zn
"}
(55,1,1) = {"
zn
zn
zn
zn
zn
zn
zn
zn
zn
zn
zn
zn
zn
zn
zn
zn
zn
zn
zn
zn
zn
zn
zn
zn
zn
zn
zn
zn
zn
zn
zn
zn
zn
zn
zn
zn
zn
zn
zn
zn
zn
zn
zn
zn
zn
zn
zn
zn
zn
zn
zn
zn
zn
zn
zn
zn
zn
"}
