//MAP CONVERTED BY dmm2tgm.py THIS HEADER COMMENT PREVENTS RECONVERSION, DO NOT REMOVE
"a" = (
/turf/template_noop,
/area/space)
"c" = (
/obj/effect/decal/cleanable/blood,
/obj/effect/decal/remains/human,
/turf/open/floor/plating/asteroid,
/area/ruin/space/has_grav)
"d" = (
/obj/item/clothing/suit/cultrobes,
/obj/item/clothing/shoes/cult/alt,
/turf/open/floor/plating/asteroid,
/area/ruin/space/has_grav)
"e" = (
/turf/open/floor/holofloor/asteroid,
/area/ruin/space/has_grav)
"g" = (
/turf/open/floor/plating/asteroid,
/area/ruin/space/has_grav)
"i" = (
/obj/effect/decal/cleanable/blood/tracks,
/obj/effect/decal/remains/human,
/turf/open/floor/plating/asteroid,
/area/ruin/space/has_grav)
"j" = (
/obj/item/flashlight/lantern{
	light_color = "#FF0000";
	name = "cultist lantern";
	on = 1
	},
/turf/open/floor/plating/asteroid,
/area/ruin/space/has_grav)
"k" = (
/obj/effect/decal/cleanable/blood/tracks,
/obj/effect/decal/cleanable/blood/old,
/obj/effect/clockwork/overlay/floor/bloodcult,
/obj/effect/temp_visual/cult/turf/floor,
/turf/open/floor/plating/asteroid,
/area/ruin/space/has_grav)
"n" = (
/obj/effect/rune/narsie,
/obj/item/melee/cultblade/dagger,
/obj/effect/decal/cleanable/blood/gibs/human,
/obj/effect/decal/cleanable/blood/old,
/obj/effect/clockwork/overlay/floor/bloodcult,
/turf/open/floor/plating/asteroid,
/area/ruin/space/has_grav)
"p" = (
/obj/item/paper/crumpled{
	info = "Soon, all shall see the wonders my savior Nar'Sie will bestow upon this realm of mortals. For they have been blinded by lies and deceat. My master, my savior is thy only one who can show them the true meaning of life. To grovel beneath the feet of our lord and to serve there will for thee rest of eternity!        May thy savior cometh too me- Believes-In-Narsie"
	},
/turf/open/floor/plating/asteroid,
/area/ruin/space/has_grav)
"q" = (
/obj/structure/trap/fire,
/turf/open/floor/plating/asteroid,
/area/ruin/space/has_grav)
"r" = (
/obj/effect/decal/cleanable/blood/gibs/human,
/obj/effect/decal/cleanable/blood/old,
/obj/effect/decal/cleanable/blood/old,
/obj/effect/clockwork/overlay/floor/bloodcult,
/obj/effect/temp_visual/cult/turf/floor,
/turf/open/floor/plating/asteroid,
/area/ruin/space/has_grav)
"t" = (
/obj/effect/decal/cleanable/blood/old,
/turf/open/floor/plating/asteroid,
/area/ruin/space/has_grav)
"u" = (
/obj/item/cult_bastard,
/obj/structure/trap/fire,
/turf/open/floor/plating/asteroid,
/area/ruin/space/has_grav)
"x" = (
/mob/living/simple_animal/hostile/construct/wraith/hostile,
/turf/open/floor/plating/asteroid,
/area/ruin/space/has_grav)
"z" = (
/obj/effect/decal/cleanable/blood/tracks,
/turf/open/floor/plating/asteroid,
/area/ruin/space/has_grav)
"A" = (
/obj/effect/decal/cleanable/blood/gibs/human/body,
/obj/effect/decal/cleanable/blood/splats,
/turf/open/floor/plating/asteroid,
/area/ruin/space/has_grav)
"I" = (
/obj/effect/decal/cleanable/blood/gibs/body,
/obj/effect/decal/cleanable/blood/splats,
/obj/effect/decal/remains/human,
/turf/open/floor/plating/asteroid,
/area/ruin/space/has_grav)
"M" = (
/obj/effect/decal/cleanable/blood/gibs/human,
/turf/open/floor/plating/asteroid,
/area/ruin/space/has_grav)
"O" = (
/obj/effect/decal/cleanable/blood/splats,
/turf/open/floor/plating/asteroid,
/area/ruin/space/has_grav)
"P" = (
/mob/living/simple_animal/hostile/construct/armored/hostile,
/turf/open/floor/plating/asteroid,
/area/ruin/space/has_grav)
"R" = (
/turf/closed/indestructible/rock,
/area/ruin/space/has_grav)
"X" = (
/obj/effect/clockwork/overlay/floor/bloodcult,
/obj/effect/temp_visual/cult/turf/floor,
/turf/open/floor/plating/asteroid,
/area/ruin/space/has_grav)
"Y" = (
/obj/effect/spawner/trap,
/turf/open/floor/plating/asteroid,
/area/ruin/space/has_grav)

(1,1,1) = {"
a
a
a
a
a
a
a
a
a
g
a
a
a
a
a
a
a
a
a
a
"}
(2,1,1) = {"
a
a
a
a
a
a
a
a
a
g
a
a
a
a
a
a
a
a
a
a
"}
(3,1,1) = {"
a
a
a
a
a
g
a
a
a
g
a
a
g
a
a
a
a
a
a
a
"}
(4,1,1) = {"
a
a
a
a
a
g
g
g
g
g
g
a
g
a
a
a
a
a
a
a
"}
(5,1,1) = {"
a
a
a
a
g
R
R
g
R
Y
g
R
g
a
a
a
a
a
a
a
"}
(6,1,1) = {"
a
a
g
g
R
P
R
R
R
X
R
R
R
g
a
a
a
a
a
a
"}
(7,1,1) = {"
a
a
a
a
R
X
g
t
g
g
X
R
R
g
g
g
a
a
a
a
"}
(8,1,1) = {"
a
a
a
g
R
d
X
j
g
g
d
q
I
R
R
a
a
a
a
a
"}
(9,1,1) = {"
a
a
a
g
Y
g
X
g
X
g
g
g
X
X
X
a
a
a
a
a
"}
(10,1,1) = {"
a
a
g
g
R
R
u
X
n
k
z
z
z
i
X
X
g
g
a
a
"}
(11,1,1) = {"
a
a
a
g
R
R
R
X
r
M
X
A
g
g
g
g
a
a
a
a
"}
(12,1,1) = {"
a
g
g
q
g
R
R
X
g
g
p
X
R
R
g
a
a
a
a
a
"}
(13,1,1) = {"
a
a
a
g
g
c
R
d
O
g
Y
X
R
x
g
a
a
a
a
a
"}
(14,1,1) = {"
a
a
a
a
g
g
R
R
R
R
g
X
X
g
q
g
a
a
a
a
"}
(15,1,1) = {"
a
a
a
a
g
x
e
R
g
g
g
g
a
a
a
a
a
a
a
a
"}
(16,1,1) = {"
a
a
a
a
g
g
e
R
g
a
a
g
a
a
a
a
a
a
a
a
"}
(17,1,1) = {"
a
a
a
a
g
a
a
g
a
a
a
a
a
a
a
a
a
a
a
a
"}
(18,1,1) = {"
a
a
a
a
g
a
a
a
a
a
a
a
a
a
a
a
a
a
a
a
"}
(19,1,1) = {"
a
a
a
a
g
a
a
a
a
a
a
a
a
a
a
a
a
a
a
a
"}
(20,1,1) = {"
a
a
a
a
a
a
a
a
a
a
a
a
a
a
a
a
a
a
a
a
"}
