//MAP CONVERTED BY dmm2tgm.py THIS HEADER COMMENT PREVENTS RECONVERSION, DO NOT REMOVE
"a" = (
/turf/template_noop,
/area/template_noop)
"h" = (
/obj/structure/lattice,
/turf/open/space/basic,
/area/ruin/unpowered/no_grav)
"j" = (
/turf/open/floor/plasteel/airless,
/area/ruin/unpowered/no_grav)
"l" = (
/obj/structure/door_assembly/door_assembly_ext,
/turf/open/floor/plating/airless,
/area/ruin/unpowered/no_grav)
"w" = (
/obj/effect/spawner/structure/window/reinforced,
/turf/open/floor/plating/airless,
/area/ruin/unpowered/no_grav)
"A" = (
/obj/effect/decal/remains/human,
/obj/effect/decal/cleanable/blood,
/turf/open/floor/plating/airless,
/area/ruin/unpowered/no_grav)
"E" = (
/obj/structure/closet/crate,
/obj/item/stack/ore/diamond{
	amount = 20
	},
/obj/item/stack/ore/plasma{
	amount = 35
	},
/obj/item/stack/ore/titanium{
	amount = 25
	},
/turf/open/floor/plasteel/airless,
/area/ruin/unpowered/no_grav)
"F" = (
/turf/closed/wall/r_wall/rust,
/area/ruin/unpowered/no_grav)
"N" = (
/obj/machinery/door/airlock/external/glass,
/turf/open/floor/plating/airless,
/area/ruin/unpowered/no_grav)
"P" = (
/turf/closed/wall/r_wall,
/area/ruin/unpowered/no_grav)
"T" = (
/obj/structure/lattice,
/obj/structure/grille,
/turf/open/space/basic,
/area/ruin/unpowered/no_grav)
"V" = (
/turf/open/floor/plating/airless,
/area/ruin/unpowered/no_grav)
"Z" = (
/obj/structure/closet/crate,
/obj/item/pickaxe/drill/diamonddrill,
/turf/open/floor/plating/airless,
/area/ruin/unpowered/no_grav)

(1,1,1) = {"
a
a
a
a
a
a
a
a
a
a
a
a
a
a
a
a
a
a
a
a
"}
(2,1,1) = {"
a
a
a
a
a
a
a
a
a
a
a
a
a
a
a
a
a
a
a
a
"}
(3,1,1) = {"
a
a
a
a
a
a
a
a
a
a
a
a
a
a
a
a
a
a
a
a
"}
(4,1,1) = {"
a
a
a
a
T
T
a
F
l
P
a
T
T
a
a
a
a
a
a
a
"}
(5,1,1) = {"
a
a
a
T
T
h
h
P
V
F
h
h
T
T
a
a
a
a
a
a
"}
(6,1,1) = {"
a
a
T
T
h
a
a
P
V
F
a
a
h
T
T
a
a
a
a
a
"}
(7,1,1) = {"
a
a
T
h
a
a
a
P
j
F
a
a
a
h
T
T
T
a
a
a
"}
(8,1,1) = {"
a
a
a
h
a
a
w
w
j
w
w
a
a
h
a
a
h
a
a
a
"}
(9,1,1) = {"
a
a
P
P
P
P
w
E
V
A
w
P
F
F
w
w
P
P
a
a
"}
(10,1,1) = {"
a
a
N
V
V
V
j
j
V
V
j
j
V
V
V
j
V
N
a
a
"}
(11,1,1) = {"
a
a
P
F
F
P
w
V
j
Z
w
P
F
P
w
w
F
F
a
a
"}
(12,1,1) = {"
a
a
a
h
a
a
w
w
V
w
w
a
a
h
a
a
h
a
a
a
"}
(13,1,1) = {"
a
a
T
h
a
a
a
P
V
P
a
a
a
h
T
T
T
a
a
a
"}
(14,1,1) = {"
a
a
T
T
h
a
a
F
V
P
a
a
h
T
T
a
a
a
a
a
"}
(15,1,1) = {"
a
a
a
T
T
h
h
F
j
F
h
h
T
T
a
a
a
a
a
a
"}
(16,1,1) = {"
a
a
a
a
T
T
a
P
N
F
a
T
T
a
a
a
a
a
a
a
"}
(17,1,1) = {"
a
a
a
a
a
a
a
a
a
a
a
a
a
a
a
a
a
a
a
a
"}
(18,1,1) = {"
a
a
a
a
a
a
a
a
a
a
a
a
a
a
a
a
a
a
a
a
"}
(19,1,1) = {"
a
a
a
a
a
a
a
a
a
a
a
a
a
a
a
a
a
a
a
a
"}
(20,1,1) = {"
a
a
a
a
a
a
a
a
a
a
a
a
a
a
a
a
a
a
a
a
"}
