//MAP CONVERTED BY dmm2tgm.py THIS HEADER COMMENT PREVENTS RECONVERSION, DO NOT REMOVE
"a" = (
/turf/template_noop,
/area/space)
"b" = (
/turf/closed/mineral/ash_rock,
/area/ruin/space/has_grav)
"d" = (
/obj/structure/stone_tile/surrounding/cracked,
/turf/open/floor/plating/asteroid/basalt,
/area/ruin/space/has_grav)
"e" = (
/obj/structure/stone_tile/surrounding/cracked{
	dir = 4
	},
/turf/open/floor/plating/asteroid/basalt,
/area/ruin/space/has_grav)
"g" = (
/obj/structure/stone_tile/center/burnt,
/turf/open/floor/plating/asteroid/basalt,
/area/ruin/space/has_grav)
"h" = (
/obj/structure/stone_tile/surrounding,
/turf/open/floor/plating/asteroid/basalt,
/area/ruin/space/has_grav)
"i" = (
/obj/structure/stone_tile/slab,
/obj/structure/stone_tile/slab,
/turf/open/floor/plating/asteroid/basalt,
/area/ruin/space/has_grav)
"k" = (
/turf/closed/wall/r_wall/rust,
/area/ruin/space/has_grav)
"l" = (
/obj/structure/stone_tile/slab/cracked,
/turf/open/floor/plating/asteroid/basalt,
/area/ruin/space/has_grav)
"m" = (
/obj/structure/stone_tile/center,
/turf/open/floor/plating/asteroid/basalt,
/area/ruin/space/has_grav)
"n" = (
/turf/open/floor/plasteel/cult,
/area/ruin/space/has_grav)
"o" = (
/obj/structure/stone_tile/surrounding/cracked{
	dir = 1
	},
/turf/open/floor/plating/asteroid/basalt,
/area/ruin/space/has_grav)
"p" = (
/turf/closed/indestructible/necropolis,
/area/ruin/space/has_grav)
"q" = (
/obj/structure/stone_tile/surrounding/cracked{
	dir = 8
	},
/turf/open/floor/plating/asteroid/basalt,
/area/ruin/space/has_grav)
"r" = (
/mob/living/simple_animal/hostile/megafauna/wendigo{
	mob_size = 5;
	resize = 2
	},
/turf/open/floor/plating/asteroid/basalt,
/area/ruin/space/has_grav)
"s" = (
/obj/structure/stone_tile/surrounding_tile/burnt{
	dir = 8
	},
/turf/open/floor/plating/asteroid/basalt,
/area/ruin/space/has_grav)
"t" = (
/obj/structure/stone_tile/surrounding_tile,
/turf/open/floor/plating/asteroid/basalt,
/area/ruin/space/has_grav)
"u" = (
/obj/structure/stone_tile/block{
	dir = 1
	},
/turf/open/floor/plating/asteroid/basalt,
/area/ruin/space/has_grav)
"v" = (
/turf/open/lava/smooth,
/area/ruin/space/has_grav)
"w" = (
/obj/structure/stone_tile{
	dir = 8
	},
/turf/open/floor/plating/asteroid/basalt,
/area/ruin/space/has_grav)
"x" = (
/obj/structure/stone_tile/center/cracked,
/turf/open/floor/plating/asteroid/basalt,
/area/ruin/space/has_grav)
"y" = (
/obj/structure/stone_tile,
/turf/open/floor/plating/asteroid/basalt,
/area/ruin/space/has_grav)
"z" = (
/obj/structure/stone_tile/burnt{
	dir = 8
	},
/turf/open/floor/plating/asteroid/basalt,
/area/ruin/space/has_grav)
"B" = (
/obj/structure/stone_tile/burnt,
/turf/open/floor/plating/asteroid/basalt,
/area/ruin/space/has_grav)
"C" = (
/obj/structure/stone_tile/block/burnt{
	dir = 1
	},
/turf/open/floor/plating/asteroid/basalt,
/area/ruin/space/has_grav)
"E" = (
/obj/structure/stone_tile/slab,
/obj/item/paper/crumpled{
	info = "i should have never touched it. i am but a fool...";
	name = "regret"
	},
/turf/open/floor/plating/asteroid/basalt,
/area/ruin/space/has_grav)
"F" = (
/obj/structure/stone_tile/block/cracked{
	dir = 1
	},
/turf/open/floor/plating/asteroid/basalt,
/area/ruin/space/has_grav)
"G" = (
/obj/effect/temp_visual/lava_warning,
/turf/open/floor/plating/asteroid/basalt,
/area/ruin/space/has_grav)
"H" = (
/obj/structure/necropolis_arch,
/obj/structure/stone_tile/slab,
/turf/open/floor/plating/asteroid/basalt,
/area/ruin/space/has_grav)
"I" = (
/obj/structure/stone_tile/block,
/obj/structure/stone_tile/block,
/turf/open/floor/plating/asteroid/basalt,
/area/ruin/space/has_grav)
"J" = (
/obj/effect/decal/cleanable/blood/gibs,
/turf/open/floor/plating/asteroid/basalt,
/area/ruin/space/has_grav)
"K" = (
/obj/effect/decal/cleanable/blood/old,
/obj/item/bodypart/head/devil,
/turf/open/floor/plating/asteroid/basalt,
/area/ruin/space/has_grav)
"L" = (
/obj/effect/decal/cleanable/blood/gibs,
/obj/item/kinetic_crusher,
/turf/open/floor/plating/asteroid/basalt,
/area/ruin/space/has_grav)
"O" = (
/turf/open/floor/plating/asteroid/basalt,
/area/ruin/space/has_grav)
"P" = (
/obj/structure/necropolis_gate,
/obj/structure/stone_tile/slab/cracked,
/turf/open/floor/plating/asteroid/basalt,
/area/ruin/space/has_grav)
"Q" = (
/obj/structure/stone_tile/slab,
/turf/open/floor/plating/asteroid/basalt,
/area/ruin/space/has_grav)
"R" = (
/turf/open/chasm/lavaland,
/area/ruin/space/has_grav)
"S" = (
/obj/structure/stone_tile/slab/burnt,
/turf/open/floor/plating/asteroid/basalt,
/area/ruin/space/has_grav)
"T" = (
/obj/item/gps/mining{
	gpstag = "_errorcode-hostile_"
	},
/turf/open/floor/plating/asteroid/basalt,
/area/ruin/space/has_grav)
"V" = (
/obj/structure/mineral_door/sandstone,
/turf/open/floor/holofloor/basalt,
/area/ruin/space/has_grav)
"W" = (
/obj/structure/stone_tile/surrounding/burnt,
/turf/open/floor/plating/asteroid/basalt,
/area/ruin/space/has_grav)
"X" = (
/obj/structure/lattice,
/turf/open/space/basic,
/area/space)
"Z" = (
/obj/structure/lattice/catwalk,
/turf/open/space/basic,
/area/space)

(1,1,1) = {"
a
a
a
a
a
a
a
a
a
a
a
a
a
a
a
a
a
a
a
a
a
a
a
a
a
a
a
a
a
a
a
a
a
a
a
a
a
a
a
a
a
a
a
a
a
a
a
a
a
a
a
a
a
a
a
a
a
a
a
a
a
a
a
"}
(2,1,1) = {"
a
a
a
a
a
a
a
a
a
a
a
a
a
a
a
a
a
a
a
a
a
a
a
a
a
a
a
a
a
a
a
a
a
a
a
a
a
a
a
a
a
a
a
a
a
a
a
a
a
a
a
a
a
a
a
a
a
a
a
a
a
a
a
"}
(3,1,1) = {"
a
a
a
a
a
a
a
a
a
a
a
a
a
a
a
a
a
a
a
k
k
k
k
k
k
k
k
k
k
k
k
a
a
a
a
a
a
a
a
a
a
a
a
a
a
a
a
a
a
a
a
a
a
a
a
a
a
a
a
a
a
a
a
"}
(4,1,1) = {"
a
a
a
a
a
a
a
a
a
a
a
a
a
a
k
k
k
k
k
p
p
p
p
p
p
p
p
p
p
p
p
k
k
k
k
k
a
a
a
a
a
a
a
a
a
a
a
a
a
a
a
a
a
a
a
a
a
a
a
a
a
a
a
"}
(5,1,1) = {"
a
a
a
a
a
a
a
a
a
a
a
k
k
k
p
p
p
p
p
v
v
Q
v
v
v
v
v
v
v
v
v
p
p
p
p
p
k
k
k
a
a
a
a
a
a
a
a
a
a
a
a
a
a
a
a
a
a
a
a
a
a
a
a
"}
(6,1,1) = {"
a
a
a
a
a
a
a
a
a
k
k
p
p
p
v
v
v
v
v
O
O
Q
Q
O
O
O
O
O
O
O
O
v
v
v
v
v
p
p
p
k
k
a
a
a
a
a
a
a
a
a
a
a
a
a
a
a
a
a
a
a
a
a
a
"}
(7,1,1) = {"
a
a
a
a
a
a
a
a
k
p
p
v
v
v
O
O
O
O
O
O
O
Q
Q
O
O
O
O
O
O
O
O
O
O
O
O
O
v
v
v
p
p
k
a
a
a
a
a
a
a
a
a
a
a
a
a
a
a
a
a
a
a
a
a
"}
(8,1,1) = {"
a
a
a
a
a
a
a
k
p
v
v
O
O
O
O
O
O
O
O
O
Q
O
l
O
O
O
O
O
O
O
O
O
O
O
O
O
O
O
O
v
v
p
k
a
a
a
a
a
a
a
a
a
a
a
a
a
a
a
a
a
a
a
a
"}
(9,1,1) = {"
a
a
a
a
a
a
k
p
v
O
O
O
O
O
O
O
O
O
O
O
m
O
Q
O
O
O
O
O
O
O
O
O
O
O
O
O
O
O
O
O
O
v
p
k
a
a
a
a
a
a
a
a
a
a
a
a
a
a
a
a
a
a
a
"}
(10,1,1) = {"
a
a
a
a
a
k
p
v
O
O
O
O
O
O
O
O
O
O
O
O
m
O
O
Q
O
O
O
O
O
O
O
O
O
O
O
O
O
O
O
O
O
O
v
p
k
a
a
a
a
a
a
a
a
a
a
a
a
a
a
a
a
a
a
"}
(11,1,1) = {"
a
a
a
a
k
p
v
O
O
O
O
O
O
O
O
O
O
O
O
O
S
O
O
Q
O
O
O
O
O
O
O
O
O
O
O
O
O
O
O
O
O
O
O
v
p
k
a
a
a
a
a
a
a
a
a
a
a
a
a
a
a
a
a
"}
(12,1,1) = {"
a
a
a
a
k
p
v
O
O
O
O
O
O
O
O
O
O
O
O
O
x
O
O
O
l
O
O
O
O
O
O
O
O
O
O
O
O
O
O
O
O
O
O
v
p
k
a
a
a
a
a
a
a
a
a
a
a
a
a
a
a
a
a
"}
(13,1,1) = {"
a
a
a
a
k
p
v
O
O
O
O
O
O
O
O
O
Q
l
Q
O
Q
O
O
O
Q
O
Q
Q
e
O
O
O
O
O
O
O
O
O
O
O
Q
x
x
Q
p
k
a
a
a
a
a
a
a
a
a
a
a
a
a
a
a
a
a
"}
(14,1,1) = {"
a
a
a
k
p
v
O
O
O
O
O
O
O
O
Q
h
O
O
O
O
Q
O
O
O
l
O
O
O
O
Q
Q
O
O
O
O
O
O
O
Q
S
O
O
O
Q
v
p
k
a
a
a
a
a
a
a
a
a
a
a
a
a
a
a
a
"}
(15,1,1) = {"
a
a
a
k
p
v
O
O
O
O
O
O
W
Q
O
O
O
O
O
O
Q
O
O
O
O
Q
O
O
O
O
O
Q
O
O
O
Q
l
Q
O
O
O
O
Q
O
v
p
k
a
a
a
a
a
a
a
a
a
a
a
a
a
a
a
a
"}
(16,1,1) = {"
a
a
a
k
p
v
O
O
O
O
O
Q
O
O
O
O
O
O
O
Q
O
O
O
O
O
Q
O
O
O
O
O
O
O
i
x
O
O
O
O
O
O
O
x
O
v
p
k
a
a
a
a
a
a
a
a
a
a
a
a
a
a
a
a
"}
(17,1,1) = {"
a
a
a
k
p
v
O
O
O
O
O
Q
O
O
O
O
O
O
O
x
O
O
O
O
O
O
Q
O
O
W
Q
x
g
O
O
O
O
O
O
O
O
l
O
O
v
p
k
a
a
a
a
a
a
a
a
a
a
a
a
a
a
a
a
"}
(18,1,1) = {"
a
a
k
p
v
O
O
O
O
O
Q
O
O
O
O
O
O
O
O
S
O
O
O
O
O
O
S
Q
Q
O
O
O
O
O
O
O
O
O
O
O
S
O
O
O
O
v
p
k
a
a
a
a
a
a
a
a
a
a
a
a
a
a
a
"}
(19,1,1) = {"
a
a
k
p
v
O
O
O
O
O
h
O
O
O
O
O
O
O
O
Q
O
O
O
O
O
O
Q
O
O
O
O
O
O
O
O
O
O
O
O
Q
O
O
O
O
O
v
p
k
a
a
a
a
a
a
a
a
a
a
a
a
a
a
a
"}
(20,1,1) = {"
a
a
k
p
v
O
O
O
O
e
O
O
O
O
O
O
O
O
O
Q
O
O
O
O
O
O
Q
O
O
O
O
O
O
O
O
O
O
O
O
x
O
O
O
O
O
v
p
k
a
a
a
a
a
a
a
a
a
a
a
a
a
a
a
"}
(21,1,1) = {"
a
a
k
p
v
O
O
O
O
Q
O
O
O
O
O
O
O
O
O
l
O
O
O
O
O
O
O
Q
O
O
O
O
O
O
O
O
O
O
Q
O
O
O
O
O
O
v
p
k
k
k
k
a
a
a
a
a
a
a
a
a
a
a
a
"}
(22,1,1) = {"
a
a
k
p
v
O
O
O
O
l
O
O
O
O
O
O
O
Q
Q
O
O
O
O
O
O
O
O
x
O
O
O
O
O
O
O
O
O
x
O
O
O
O
O
O
O
v
p
p
p
b
b
k
k
a
a
a
a
a
a
a
a
a
a
"}
(23,1,1) = {"
a
a
k
p
v
O
O
O
O
Q
O
O
O
O
Q
W
S
O
O
O
O
O
O
n
O
O
O
Q
Q
S
S
x
Q
O
O
O
Q
O
O
O
O
O
O
O
O
G
p
O
O
b
R
b
b
k
k
a
a
a
a
a
a
a
a
"}
(24,1,1) = {"
a
a
k
p
v
O
O
O
O
l
O
O
l
Q
O
O
O
O
O
O
O
n
n
n
n
n
O
l
O
O
O
O
O
Q
S
x
O
O
O
O
O
O
O
O
O
O
p
O
O
b
O
R
R
b
b
k
a
a
a
a
a
a
a
"}
(25,1,1) = {"
a
a
k
p
v
O
O
O
O
Q
g
Q
O
O
O
O
O
O
O
O
n
Q
Q
Q
Q
Q
n
Q
O
O
O
O
O
O
O
O
Q
Q
x
x
O
O
O
O
O
O
p
O
O
b
O
O
O
R
R
k
a
X
a
a
a
a
a
"}
(26,1,1) = {"
a
a
k
p
v
O
O
Q
S
O
O
O
O
O
O
O
O
O
O
n
Q
Q
Q
Q
Q
Q
Q
n
O
O
O
O
O
O
O
O
O
O
O
O
Q
E
Q
O
O
O
p
O
z
b
T
O
O
O
O
k
X
X
a
a
a
a
a
"}
(27,1,1) = {"
a
a
k
p
v
Q
Q
O
O
O
O
O
O
O
O
O
O
O
n
Q
Q
Q
o
O
e
Q
i
Q
n
O
O
O
O
O
s
O
w
O
z
O
w
O
z
O
z
O
O
w
l
O
O
O
O
O
O
k
Z
Z
X
X
X
X
a
"}
(28,1,1) = {"
a
a
k
p
Q
O
O
O
O
O
O
O
O
O
O
O
O
n
n
Q
Q
Q
O
r
O
Q
Q
Q
n
n
O
O
O
O
d
u
S
u
S
C
Q
F
l
u
Q
C
H
I
Q
P
O
O
O
O
O
V
Z
Z
Z
X
a
a
a
"}
(29,1,1) = {"
a
a
k
p
v
Q
S
O
O
O
O
O
O
O
O
O
O
O
n
Q
Q
Q
q
O
d
Q
Q
Q
n
O
O
O
O
O
t
O
y
O
B
O
y
O
B
O
B
O
O
y
l
O
O
O
O
O
O
k
Z
Z
X
a
a
a
a
"}
(30,1,1) = {"
a
a
k
p
v
O
O
d
Q
O
O
O
O
O
O
O
O
O
O
n
Q
Q
Q
Q
Q
Q
Q
n
O
O
O
O
O
O
O
O
O
O
O
O
Q
W
Q
O
O
O
p
O
B
b
O
O
O
O
O
k
X
X
a
a
a
a
a
"}
(31,1,1) = {"
a
a
k
p
v
O
O
O
O
S
O
Q
O
O
O
O
O
O
O
O
n
Q
Q
Q
Q
Q
n
Q
O
O
O
O
O
O
O
O
Q
x
O
Q
O
O
O
O
O
O
p
J
O
b
O
O
O
R
R
k
X
a
a
a
a
a
a
"}
(32,1,1) = {"
a
a
k
p
v
O
O
O
O
O
O
O
Q
x
O
O
O
O
O
O
O
n
n
n
n
n
O
S
O
O
O
O
O
Q
W
Q
O
O
O
O
O
O
O
O
O
O
p
K
L
b
O
R
R
b
b
k
X
a
a
a
a
a
a
"}
(33,1,1) = {"
a
a
k
p
v
O
O
O
O
Q
O
O
O
O
Q
Q
x
O
O
O
O
O
O
n
O
O
O
x
Q
d
O
O
Q
O
O
O
Q
O
O
O
O
O
O
O
O
G
p
O
J
b
R
b
b
k
k
a
a
a
a
a
a
a
a
"}
(34,1,1) = {"
a
a
k
p
v
O
O
O
O
O
O
O
O
O
O
O
O
W
Q
O
O
O
O
O
O
O
O
Q
O
O
O
O
O
O
O
O
O
Q
O
O
O
O
O
O
O
v
p
p
p
b
b
k
k
a
a
a
a
a
a
a
a
a
a
"}
(35,1,1) = {"
a
a
k
p
v
O
O
O
O
g
O
O
O
O
O
O
O
O
O
x
O
O
O
O
O
O
O
Q
O
O
O
O
O
O
O
O
O
O
x
O
O
O
O
O
O
v
p
k
k
k
k
a
a
a
a
a
a
a
a
a
a
a
a
"}
(36,1,1) = {"
a
a
k
p
v
O
O
O
O
Q
O
O
O
O
O
O
O
O
O
Q
O
O
O
O
O
O
l
O
O
O
O
O
O
O
O
O
O
O
O
Q
O
O
O
O
O
v
p
k
a
a
a
a
a
a
a
a
a
a
a
a
a
a
a
"}
(37,1,1) = {"
a
a
k
p
v
O
O
O
O
O
Q
O
O
O
O
O
O
O
O
i
O
O
O
O
O
O
x
O
O
O
O
O
O
O
O
O
O
O
O
l
O
O
O
O
O
v
p
k
a
a
a
a
a
a
a
a
a
a
a
a
a
a
a
"}
(38,1,1) = {"
a
a
a
k
p
v
O
O
O
O
Q
O
O
O
O
O
O
O
O
x
O
O
O
O
O
O
x
Q
Q
O
O
O
O
O
O
O
O
O
O
O
Q
O
O
O
O
v
p
k
a
a
a
a
a
a
a
a
a
a
a
a
a
a
a
"}
(39,1,1) = {"
a
a
a
k
p
v
O
O
O
O
O
x
O
O
O
O
O
O
O
Q
O
O
O
O
O
O
Q
O
O
Q
Q
l
Q
O
O
O
O
O
O
O
O
S
O
O
v
p
k
a
a
a
a
a
a
a
a
a
a
a
a
a
a
a
a
"}
(40,1,1) = {"
a
a
a
k
p
v
O
O
O
O
O
Q
O
O
O
O
O
O
O
Q
O
O
O
O
O
Q
O
O
O
O
O
O
O
Q
Q
O
O
O
O
O
O
O
Q
O
v
p
k
a
a
a
a
a
a
a
a
a
a
a
a
a
a
a
a
"}
(41,1,1) = {"
a
a
a
k
p
v
O
O
O
O
O
O
l
d
O
O
O
O
O
O
Q
O
O
O
O
Q
O
O
O
O
O
Q
O
O
O
Q
g
Q
O
O
O
O
Q
O
v
p
k
a
a
a
a
a
a
a
a
a
a
a
a
a
a
a
a
"}
(42,1,1) = {"
a
a
a
k
p
v
O
O
O
O
O
O
O
O
Q
x
O
O
O
O
x
O
O
O
Q
O
O
O
O
Q
W
O
O
O
O
O
O
O
Q
l
O
O
O
Q
v
p
k
a
a
a
a
a
a
a
a
a
a
a
a
a
a
a
a
"}
(43,1,1) = {"
a
a
a
a
k
p
v
O
O
O
O
O
O
O
O
O
Q
x
Q
O
o
O
O
O
x
O
Q
Q
l
O
O
O
O
O
O
O
O
O
O
O
Q
O
x
Q
p
k
a
a
a
a
a
a
a
a
a
a
a
a
a
a
a
a
a
"}
(44,1,1) = {"
a
a
a
a
k
p
v
O
O
O
O
O
O
O
O
O
O
O
O
O
x
O
O
O
Q
O
O
O
O
O
O
O
O
O
O
O
O
O
O
O
O
O
O
v
p
k
a
a
a
a
a
a
a
a
a
a
a
a
a
a
a
a
a
"}
(45,1,1) = {"
a
a
a
a
k
p
v
O
O
O
O
O
O
O
O
O
O
O
O
O
x
O
O
Q
O
O
O
O
O
O
O
O
O
O
O
O
O
O
O
O
O
O
O
v
p
k
a
a
a
a
a
a
a
a
a
a
a
a
a
a
a
a
a
"}
(46,1,1) = {"
a
a
a
a
a
k
p
v
O
O
O
O
O
O
O
O
O
O
O
O
Q
O
O
Q
O
O
O
O
O
O
O
O
O
O
O
O
O
O
O
O
O
O
v
p
k
a
a
a
a
a
a
a
a
a
a
a
a
a
a
a
a
a
a
"}
(47,1,1) = {"
a
a
a
a
a
a
k
p
v
O
O
O
O
O
O
O
O
O
O
O
l
O
Q
O
O
O
O
O
O
O
O
O
O
O
O
O
O
O
O
O
O
v
p
k
a
a
a
a
a
a
a
a
a
a
a
a
a
a
a
a
a
a
a
"}
(48,1,1) = {"
a
a
a
a
a
a
a
k
p
v
v
O
O
O
O
O
O
O
O
O
l
O
x
O
O
O
O
O
O
O
O
O
O
O
O
O
O
O
O
v
v
p
k
a
a
a
a
a
a
a
a
a
a
a
a
a
a
a
a
a
a
a
a
"}
(49,1,1) = {"
a
a
a
a
a
a
a
a
k
p
p
v
v
v
O
O
O
O
O
O
O
Q
x
O
O
O
O
O
O
O
O
O
O
O
O
O
v
v
v
p
p
k
a
a
a
a
a
a
a
a
a
a
a
a
a
a
a
a
a
a
a
a
a
"}
(50,1,1) = {"
a
a
a
a
a
a
a
a
a
k
k
p
p
p
v
v
v
v
v
O
O
l
Q
O
O
O
O
O
O
O
O
v
v
v
v
v
p
p
p
k
k
a
a
a
a
a
a
a
a
a
a
a
a
a
a
a
a
a
a
a
a
a
a
"}
(51,1,1) = {"
a
a
a
a
a
a
a
a
a
a
a
k
k
k
p
p
p
p
p
v
v
Q
v
v
v
v
v
v
v
v
v
p
p
p
p
p
k
k
k
a
a
a
a
a
a
a
a
a
a
a
a
a
a
a
a
a
a
a
a
a
a
a
a
"}
(52,1,1) = {"
a
a
a
a
a
a
a
a
a
a
a
a
a
a
k
k
k
k
k
p
p
p
p
p
p
p
p
p
p
p
p
k
k
k
k
k
a
a
a
a
a
a
a
a
a
a
a
a
a
a
a
a
a
a
a
a
a
a
a
a
a
a
a
"}
(53,1,1) = {"
a
a
a
a
a
a
a
a
a
a
a
a
a
a
a
a
a
a
a
k
k
k
k
k
k
k
k
k
k
k
k
a
a
a
a
a
a
a
a
a
a
a
a
a
a
a
a
a
a
a
a
a
a
a
a
a
a
a
a
a
a
a
a
"}
(54,1,1) = {"
a
a
a
a
a
a
a
a
a
a
a
a
a
a
a
a
a
a
a
a
a
a
a
a
a
a
a
a
a
a
a
a
a
a
a
a
a
a
a
a
a
a
a
a
a
a
a
a
a
a
a
a
a
a
a
a
a
a
a
a
a
a
a
"}
(55,1,1) = {"
a
a
a
a
a
a
a
a
a
a
a
a
a
a
a
a
a
a
a
a
a
a
a
a
a
a
a
a
a
a
a
a
a
a
a
a
a
a
a
a
a
a
a
a
a
a
a
a
a
a
a
a
a
a
a
a
a
a
a
a
a
a
a
"}
(56,1,1) = {"
a
a
a
a
a
a
a
a
a
a
a
a
a
a
a
a
a
a
a
a
a
a
a
a
a
a
a
a
a
a
a
a
a
a
a
a
a
a
a
a
a
a
a
a
a
a
a
a
a
a
a
a
a
a
a
a
a
a
a
a
a
a
a
"}
