//MAP CONVERTED BY dmm2tgm.py THIS HEADER COMMENT PREVENTS RECONVERSION, DO NOT REMOVE
"ae" = (
/obj/machinery/light/small{
	dir = 4
	},
/turf/open/floor/carpet/royalblack,
/area/ruin/space/has_grav)
"aj" = (
/obj/machinery/atmospherics/components/unary/vent_pump/on{
	dir = 1
	},
/obj/machinery/atmospherics/pipe/simple/scrubbers/hidden{
	dir = 4
	},
/turf/open/floor/carpet/royalblack,
/area/ruin/space/has_grav)
"aD" = (
/obj/structure/toilet{
	dir = 8
	},
/obj/machinery/light/small,
/turf/open/floor/mineral/titanium/white,
/area/ruin/space/has_grav)
"aY" = (
/obj/machinery/door/airlock/external/glass,
/obj/structure/fans/tiny,
/turf/open/floor/mineral/plastitanium,
/area/ruin/space/has_grav)
"ba" = (
/obj/effect/spawner/structure/window/plasma/reinforced,
/obj/structure/grille,
/turf/open/space/basic,
/area/ruin/space/has_grav)
"bd" = (
/obj/machinery/porta_turret/syndicate{
	dir = 9
	},
/turf/closed/wall/r_wall,
/area/ruin/space/has_grav)
"bf" = (
/obj/machinery/rnd/production/techfab/department/medical,
/turf/open/floor/mineral/titanium/white,
/area/ruin/space/has_grav)
"bi" = (
/obj/machinery/atmospherics/pipe/manifold/scrubbers/hidden,
/turf/closed/mineral/random,
/area/ruin/space/has_grav)
"bq" = (
/obj/structure/flora/ausbushes/fullgrass,
/obj/item/reagent_containers/glass/bucket,
/turf/open/floor/grass,
/area/ruin/space/has_grav)
"bv" = (
/obj/structure/cable{
	icon_state = "4-8"
	},
/obj/machinery/atmospherics/pipe/simple/supply/hidden{
	dir = 4
	},
/turf/open/floor/mineral/plastitanium,
/area/ruin/space/has_grav)
"bQ" = (
/turf/open/floor/plating/asteroid/airless,
/area/ruin/unpowered/no_grav)
"ca" = (
/obj/effect/mob_spawn/human/syndicate{
	dir = 4;
	name = "Syndicate Infiltration Agent";
	short_desc = "You are a Syndicate, you have been tasked with retrieving the Captains Antique Raygun aboard the highly classified Nanotrasen base within your nearby sector. Good luck Soldier."
	},
/obj/structure/bed{
	dir = 1
	},
/obj/item/crowbar,
/turf/open/floor/carpet/royalblack,
/area/ruin/space/has_grav)
"cs" = (
/obj/machinery/atmospherics/pipe/simple/supply/hidden{
	dir = 4
	},
/turf/open/floor/mineral/plastitanium/red,
/area/ruin/space/has_grav)
"cZ" = (
/obj/structure/closet/syndicate{
	anchored = 1;
	name = "Syndicate Infiltration Locker"
	},
/obj/item/radio/headset/syndicate/alt,
/obj/item/clothing/suit/armor/vest,
/obj/item/clothing/under/syndicate,
/obj/item/melee/transforming/energy/sword/saber,
/obj/item/storage/box/syndie_kit/chameleon,
/turf/open/floor/mineral/plastitanium/red,
/area/ruin/space/has_grav)
"dd" = (
/obj/machinery/computer/camera_advanced,
/turf/open/floor/mineral/plastitanium/red,
/area/ruin/space/has_grav)
"dn" = (
/obj/structure/cable{
	icon_state = "0-4"
	},
/obj/machinery/atmospherics/pipe/simple/supply/hidden{
	dir = 4
	},
/obj/item/stack/cable_coil,
/obj/machinery/light/small,
/obj/machinery/power/apc/auto_name/north,
/turf/open/floor/plating,
/area/ruin/space/has_grav)
"dx" = (
/turf/open/floor/mineral/plastitanium,
/area/ruin/space/has_grav)
"dH" = (
/obj/structure/table/optable,
/turf/open/floor/mineral/titanium/white,
/area/ruin/space/has_grav)
"dZ" = (
/turf/open/floor/mineral/titanium/white,
/area/ruin/space/has_grav)
"ge" = (
/obj/machinery/atmospherics/pipe/simple/scrubbers/hidden{
	dir = 5
	},
/turf/closed/mineral/random,
/area/ruin/space/has_grav)
"hA" = (
/obj/machinery/atmospherics/components/unary/vent_scrubber/on,
/turf/open/floor/mineral/plastitanium/red,
/area/ruin/space/has_grav)
"ii" = (
/obj/structure/cable{
	icon_state = "2-8"
	},
/obj/machinery/atmospherics/pipe/manifold/supply/hidden{
	dir = 4
	},
/obj/item/stack/tile/mineral/plastitanium,
/obj/item/stack/tile/mineral/plastitanium,
/turf/open/floor/plating,
/area/ruin/space/has_grav)
"ik" = (
/obj/structure/cable{
	icon_state = "4-8"
	},
/turf/open/floor/plating,
/area/ruin/space/has_grav)
"iv" = (
/obj/structure/table/reinforced,
/obj/item/gun/ballistic/automatic/pistol,
/turf/open/floor/plasteel/airless/dark,
/area/ruin/space/has_grav)
"iU" = (
/obj/machinery/atmospherics/components/unary/outlet_injector/on{
	dir = 1
	},
/turf/open/floor/plating/asteroid/airless,
/area/ruin/unpowered/no_grav)
"km" = (
/obj/machinery/atmospherics/pipe/manifold/supply/hidden{
	dir = 8
	},
/turf/open/floor/mineral/plastitanium/red,
/area/ruin/space/has_grav)
"kt" = (
/obj/structure/dresser,
/obj/machinery/atmospherics/components/unary/vent_scrubber/on{
	dir = 4
	},
/turf/open/floor/carpet/royalblack,
/area/ruin/space/has_grav)
"kv" = (
/obj/machinery/shower{
	dir = 8
	},
/obj/structure/curtain,
/turf/open/floor/plasteel/showroomfloor/shower,
/area/ruin/space/has_grav)
"kG" = (
/obj/machinery/atmospherics/components/unary/vent_pump/on{
	dir = 8
	},
/turf/open/floor/mineral/titanium/white,
/area/ruin/space/has_grav)
"kM" = (
/turf/open/floor/plasteel/airless/dark,
/area/ruin/space/has_grav)
"lJ" = (
/obj/machinery/light/small,
/obj/machinery/atmospherics/pipe/simple/supply/hidden{
	dir = 4
	},
/obj/machinery/atmospherics/pipe/simple/scrubbers/hidden,
/turf/open/floor/mineral/plastitanium/red,
/area/ruin/space/has_grav)
"mw" = (
/obj/machinery/porta_turret/syndicate{
	dir = 10
	},
/turf/closed/wall/r_wall,
/area/ruin/space/has_grav)
"mL" = (
/obj/machinery/door/airlock/external/glass,
/obj/structure/fans/tiny,
/obj/structure/cable{
	icon_state = "4-8"
	},
/turf/open/floor/plating,
/area/ruin/space/has_grav)
"mM" = (
/obj/machinery/light/small{
	dir = 4
	},
/turf/open/floor/mineral/titanium/white,
/area/ruin/space/has_grav)
"nt" = (
/obj/structure/lattice/catwalk,
/obj/structure/cable{
	icon_state = "4-8"
	},
/obj/structure/cable{
	icon_state = "2-4"
	},
/turf/open/space/basic,
/area/space)
"nQ" = (
/obj/machinery/computer/rdconsole,
/turf/open/floor/mineral/plastitanium/red,
/area/ruin/space/has_grav)
"nS" = (
/obj/machinery/porta_turret/syndicate{
	dir = 5
	},
/turf/closed/wall/r_wall,
/area/ruin/space/has_grav)
"ot" = (
/obj/machinery/atmospherics/pipe/simple/scrubbers/hidden{
	dir = 4
	},
/turf/closed/wall/r_wall,
/area/ruin/space/has_grav)
"oZ" = (
/obj/item/circuitboard/machine/smes,
/turf/open/floor/plating,
/area/ruin/space/has_grav)
"pF" = (
/obj/item/seeds/cannabis,
/obj/item/seeds/carrot,
/obj/item/seeds/apple,
/obj/item/seeds/ambrosia,
/obj/item/seeds/ambrosia,
/obj/item/seeds/chili,
/obj/item/seeds/lemon,
/obj/item/seeds/tower,
/obj/item/seeds/watermelon,
/obj/item/seeds/watermelon,
/obj/machinery/light/small{
	dir = 8
	},
/turf/open/floor/grass,
/area/ruin/space/has_grav)
"qj" = (
/obj/machinery/atmospherics/components/unary/vent_pump/on,
/turf/open/floor/mineral/plastitanium/red,
/area/ruin/space/has_grav)
"re" = (
/obj/machinery/computer/message_monitor,
/obj/machinery/light/small{
	dir = 1
	},
/turf/open/floor/mineral/plastitanium/red,
/area/ruin/space/has_grav)
"rP" = (
/obj/machinery/computer/operating,
/turf/open/floor/mineral/titanium/white,
/area/ruin/space/has_grav)
"rS" = (
/obj/structure/reagent_dispensers/watertank/high,
/turf/open/floor/grass,
/area/ruin/space/has_grav)
"sn" = (
/obj/structure/table/reinforced,
/obj/item/storage/backpack/duffelbag/syndie/surgery_adv,
/obj/item/storage/firstaid/tactical/nukeop,
/turf/open/floor/mineral/titanium/white,
/area/ruin/space/has_grav)
"sx" = (
/obj/machinery/atmospherics/pipe/simple/scrubbers/hidden,
/turf/open/floor/plating/asteroid/airless,
/area/ruin/unpowered/no_grav)
"sE" = (
/obj/machinery/atmospherics/pipe/manifold/scrubbers/hidden{
	dir = 4
	},
/turf/closed/wall/r_wall,
/area/ruin/space/has_grav)
"sZ" = (
/obj/machinery/airalarm/syndicate,
/turf/closed/wall/r_wall,
/area/ruin/space/has_grav)
"tl" = (
/obj/effect/decal/remains/human,
/turf/open/floor/plating/asteroid/airless,
/area/ruin/unpowered/no_grav)
"ui" = (
/turf/template_noop,
/area/template_noop)
"vq" = (
/obj/structure/closet/syndicate{
	anchored = 1;
	name = "Syndicate Comms Locker"
	},
/obj/item/clothing/head/HoS/syndicate,
/obj/item/radio/headset/syndicate/alt,
/obj/item/clothing/under/syndicate,
/obj/machinery/light/small,
/obj/item/melee/transforming/energy/sword/saber,
/obj/item/clothing/suit/armor/vest/capcarapace/syndicate,
/turf/open/floor/mineral/plastitanium/red,
/area/ruin/space/has_grav)
"vr" = (
/obj/structure/mirror/magic{
	pixel_x = 32
	},
/turf/open/floor/mineral/titanium/white,
/area/ruin/space/has_grav)
"vO" = (
/obj/machinery/atmospherics/pipe/simple/supply/hidden{
	dir = 6
	},
/turf/open/floor/carpet/royalblack,
/area/ruin/space/has_grav)
"vT" = (
/obj/machinery/atmospherics/pipe/simple/supply/hidden{
	dir = 4
	},
/obj/machinery/atmospherics/pipe/simple/scrubbers/hidden,
/turf/open/floor/mineral/plastitanium,
/area/ruin/space/has_grav)
"vY" = (
/obj/machinery/door/airlock/hatch,
/turf/open/floor/mineral/titanium/white,
/area/ruin/space/has_grav)
"wi" = (
/obj/machinery/atmospherics/pipe/simple/scrubbers/hidden,
/turf/closed/wall/r_wall,
/area/ruin/space/has_grav)
"wP" = (
/obj/structure/flora/ausbushes/fullgrass,
/obj/machinery/atmospherics/components/unary/vent_pump/on{
	dir = 8
	},
/turf/open/floor/grass,
/area/ruin/space/has_grav)
"wX" = (
/obj/machinery/door/airlock/hatch,
/obj/structure/cable{
	icon_state = "4-8"
	},
/obj/machinery/atmospherics/pipe/simple/supply/hidden{
	dir = 4
	},
/turf/open/floor/mineral/plastitanium,
/area/ruin/space/has_grav)
"wY" = (
/obj/machinery/light/small{
	dir = 4
	},
/obj/structure/cable{
	icon_state = "1-2"
	},
/obj/machinery/atmospherics/pipe/simple/supply/hidden,
/obj/machinery/atmospherics/components/unary/vent_scrubber/on{
	dir = 4
	},
/turf/open/floor/mineral/plastitanium,
/area/ruin/space/has_grav)
"ya" = (
/obj/machinery/light/small{
	dir = 1
	},
/turf/open/floor/mineral/plastitanium,
/area/ruin/space/has_grav)
"yK" = (
/turf/open/floor/mineral/plastitanium/red,
/area/ruin/space/has_grav)
"zT" = (
/obj/machinery/atmospherics/pipe/manifold/scrubbers/hidden{
	dir = 1
	},
/turf/closed/mineral/random,
/area/ruin/space/has_grav)
"zV" = (
/obj/machinery/autolathe/hacked,
/obj/machinery/light/small{
	dir = 1
	},
/turf/open/floor/mineral/plastitanium/red,
/area/ruin/space/has_grav)
"Ad" = (
/obj/structure/tank_dispenser/oxygen,
/turf/open/floor/mineral/plastitanium,
/area/ruin/space/has_grav)
"Bh" = (
/obj/structure/lattice/catwalk,
/obj/structure/cable{
	icon_state = "4-8"
	},
/turf/open/space/basic,
/area/space)
"Br" = (
/obj/structure/closet/crate/radiation,
/obj/item/clothing/head/radiation,
/obj/item/clothing/suit/radiation,
/turf/open/floor/plating,
/area/ruin/space/has_grav)
"Cv" = (
/obj/machinery/rnd/production/circuit_imprinter,
/turf/open/floor/mineral/plastitanium/red,
/area/ruin/space/has_grav)
"CL" = (
/obj/machinery/telecomms/relay,
/turf/open/floor/plasteel/airless/dark,
/area/ruin/space/has_grav)
"Ds" = (
/obj/structure/lattice/catwalk,
/obj/structure/cable{
	icon_state = "1-4"
	},
/obj/structure/cable{
	icon_state = "4-8"
	},
/turf/open/space/basic,
/area/space)
"Dx" = (
/obj/structure/bed{
	dir = 1
	},
/obj/effect/mob_spawn/human/syndicate{
	dir = 4;
	name = "Syndicate Comms Agent";
	short_desc = "You are a Syndicate, your job is to scout out the station and gather as much intel as you can. Assure no Nanotrasen thugs step foot upon your vessel."
	},
/obj/item/crowbar,
/turf/open/floor/carpet/royalblack,
/area/ruin/space/has_grav)
"DG" = (
/obj/structure/lattice/catwalk,
/obj/structure/cable{
	icon_state = "1-4"
	},
/obj/structure/cable{
	icon_state = "1-8"
	},
/turf/open/space/basic,
/area/space)
"DW" = (
/obj/machinery/atmospherics/components/unary/vent_scrubber/on,
/obj/machinery/sleeper/syndie/fullupgrade{
	dir = 1
	},
/turf/open/floor/mineral/titanium/white,
/area/ruin/space/has_grav)
"EG" = (
/obj/machinery/atmospherics/pipe/simple/scrubbers/hidden,
/turf/closed/mineral/random,
/area/ruin/space/has_grav)
"Fv" = (
/obj/structure/lattice/catwalk,
/obj/structure/cable{
	icon_state = "2-4"
	},
/obj/structure/cable{
	icon_state = "1-2"
	},
/turf/open/space/basic,
/area/space)
"FK" = (
/obj/machinery/atmospherics/pipe/simple/supply/hidden,
/turf/open/floor/mineral/plastitanium,
/area/ruin/space/has_grav)
"FO" = (
/obj/structure/chair/office/dark{
	dir = 1
	},
/turf/open/floor/mineral/plastitanium/red,
/area/ruin/space/has_grav)
"Gb" = (
/obj/item/storage/toolbox/syndicate,
/obj/item/multitool,
/turf/open/floor/plating,
/area/ruin/space/has_grav)
"Hg" = (
/obj/machinery/atmospherics/pipe/simple/supply/hidden{
	dir = 4
	},
/turf/open/floor/mineral/plastitanium,
/area/ruin/space/has_grav)
"ID" = (
/obj/structure/lattice/catwalk,
/obj/structure/cable{
	icon_state = "1-2"
	},
/obj/structure/cable{
	icon_state = "2-4"
	},
/turf/open/space/basic,
/area/space)
"IV" = (
/obj/machinery/atmospherics/components/unary/vent_pump/on{
	dir = 8
	},
/turf/open/floor/plasteel/airless/dark,
/area/ruin/space/has_grav)
"JV" = (
/obj/structure/cable{
	icon_state = "0-4"
	},
/turf/open/floor/plating/airless,
/area/space)
"Ke" = (
/obj/structure/cable{
	icon_state = "1-2"
	},
/obj/machinery/atmospherics/pipe/manifold/supply/hidden{
	dir = 8
	},
/turf/open/floor/mineral/plastitanium,
/area/ruin/space/has_grav)
"LD" = (
/obj/structure/table/reinforced,
/obj/machinery/light/small{
	dir = 4
	},
/obj/item/storage/backpack/duffelbag/syndie/bulldogbundle,
/turf/open/floor/plasteel/airless/dark,
/area/ruin/space/has_grav)
"Mt" = (
/obj/structure/table/reinforced,
/obj/item/paper_bin,
/obj/item/pen,
/turf/open/floor/mineral/plastitanium/red,
/area/ruin/space/has_grav)
"MH" = (
/obj/machinery/atmospherics/pipe/simple/scrubbers/hidden{
	dir = 4
	},
/turf/closed/mineral/random,
/area/ruin/space/has_grav)
"MK" = (
/obj/structure/lattice/catwalk,
/obj/structure/cable{
	icon_state = "0-2"
	},
/turf/open/space/basic,
/area/space)
"MV" = (
/obj/structure/table/reinforced,
/obj/item/paper/monitorkey,
/turf/open/floor/mineral/plastitanium/red,
/area/ruin/space/has_grav)
"Nn" = (
/obj/machinery/porta_turret/syndicate,
/turf/closed/wall/r_wall,
/area/ruin/space/has_grav)
"Np" = (
/obj/structure/lattice/catwalk,
/obj/structure/cable{
	icon_state = "1-2"
	},
/obj/structure/cable{
	icon_state = "1-4"
	},
/turf/open/space/basic,
/area/space)
"Nq" = (
/obj/structure/closet/crate/solarpanel_small,
/turf/open/floor/plating,
/area/ruin/space/has_grav)
"NR" = (
/turf/open/floor/plating/airless,
/area/space)
"NY" = (
/obj/machinery/atmospherics/pipe/manifold/scrubbers/hidden{
	dir = 1
	},
/turf/closed/wall/r_wall,
/area/ruin/space/has_grav)
"Ou" = (
/obj/machinery/door/airlock/hatch,
/obj/machinery/atmospherics/pipe/simple/supply/hidden{
	dir = 4
	},
/turf/open/floor/mineral/plastitanium,
/area/ruin/space/has_grav)
"Pb" = (
/obj/machinery/atmospherics/components/unary/tank/air,
/turf/open/floor/plating,
/area/ruin/space/has_grav)
"Pr" = (
/turf/closed/mineral/random,
/area/ruin/space/has_grav)
"PU" = (
/obj/machinery/atmospherics/pipe/simple/scrubbers/hidden{
	dir = 10
	},
/turf/closed/wall/r_wall,
/area/ruin/space/has_grav)
"Qz" = (
/obj/machinery/atmospherics/pipe/simple/scrubbers/hidden{
	dir = 5
	},
/turf/closed/wall/r_wall,
/area/ruin/space/has_grav)
"QO" = (
/obj/machinery/atmospherics/components/unary/vent_pump/on{
	dir = 8
	},
/turf/open/floor/mineral/plastitanium,
/area/ruin/space/has_grav)
"RC" = (
/obj/machinery/atmospherics/pipe/simple/scrubbers/hidden{
	dir = 9
	},
/turf/closed/mineral/random,
/area/ruin/space/has_grav)
"RM" = (
/obj/machinery/door/airlock/hatch,
/obj/machinery/atmospherics/pipe/simple/supply/hidden,
/turf/open/floor/mineral/plastitanium,
/area/ruin/space/has_grav)
"Sw" = (
/obj/structure/flora/ausbushes/grassybush,
/mob/living/simple_animal/butterfly,
/turf/open/floor/grass,
/area/ruin/space/has_grav)
"SM" = (
/obj/structure/cable{
	icon_state = "0-8"
	},
/turf/open/floor/plating/airless,
/area/space)
"SN" = (
/obj/machinery/door/airlock/highsecurity,
/obj/machinery/atmospherics/pipe/simple/supply/hidden{
	dir = 4
	},
/turf/open/floor/plasteel/dark,
/area/ruin/space/has_grav)
"TK" = (
/obj/structure/cable{
	icon_state = "1-8"
	},
/obj/machinery/atmospherics/pipe/simple/supply/hidden{
	dir = 9
	},
/obj/item/kirbyplants/photosynthetic,
/turf/open/floor/mineral/plastitanium,
/area/ruin/space/has_grav)
"Un" = (
/obj/machinery/atmospherics/pipe/simple/supply/hidden{
	dir = 4
	},
/turf/open/floor/plasteel/airless/dark,
/area/ruin/space/has_grav)
"Ut" = (
/obj/structure/cable{
	icon_state = "4-8"
	},
/obj/machinery/atmospherics/components/unary/vent_pump/on{
	dir = 4
	},
/turf/open/floor/plating,
/area/ruin/space/has_grav)
"UD" = (
/obj/machinery/light/small{
	dir = 4
	},
/obj/structure/cable{
	icon_state = "1-2"
	},
/obj/machinery/atmospherics/pipe/simple/supply/hidden,
/obj/machinery/atmospherics/pipe/simple/scrubbers/hidden{
	dir = 4
	},
/turf/open/floor/mineral/plastitanium,
/area/ruin/space/has_grav)
"UQ" = (
/obj/machinery/porta_turret/syndicate{
	dir = 6
	},
/turf/closed/wall/r_wall,
/area/ruin/space/has_grav)
"VP" = (
/turf/closed/wall/r_wall,
/area/ruin/space/has_grav)
"Wd" = (
/obj/machinery/rnd/production/techfab/department/science,
/turf/open/floor/mineral/plastitanium/red,
/area/ruin/space/has_grav)
"WK" = (
/obj/machinery/atmospherics/pipe/simple/supply/hidden{
	dir = 4
	},
/obj/item/kirbyplants/photosynthetic,
/turf/open/floor/mineral/plastitanium/red,
/area/ruin/space/has_grav)
"WT" = (
/obj/structure/cable{
	icon_state = "1-2"
	},
/obj/machinery/atmospherics/pipe/simple/supply/hidden,
/turf/open/floor/mineral/plastitanium,
/area/ruin/space/has_grav)
"WV" = (
/obj/machinery/ore_silo,
/turf/open/floor/plasteel/airless/dark,
/area/ruin/space/has_grav)
"Xk" = (
/obj/machinery/mineral/bluespace_miner,
/turf/open/floor/plasteel/airless/dark,
/area/ruin/space/has_grav)
"Xn" = (
/obj/item/pickaxe,
/turf/open/floor/plating/asteroid/airless,
/area/ruin/unpowered/no_grav)
"Xs" = (
/obj/machinery/suit_storage_unit/syndicate,
/turf/open/floor/mineral/plastitanium,
/area/ruin/space/has_grav)
"YI" = (
/obj/machinery/hydroponics/constructable,
/turf/open/floor/grass,
/area/ruin/space/has_grav)
"YY" = (
/obj/structure/cable{
	icon_state = "4-8"
	},
/obj/machinery/atmospherics/pipe/manifold/supply/hidden,
/turf/open/floor/plating,
/area/ruin/space/has_grav)
"Zn" = (
/obj/structure/lattice/catwalk,
/turf/open/space/basic,
/area/space)
"Zo" = (
/obj/machinery/rnd/production/techfab/department/engineering,
/obj/machinery/light/small,
/turf/open/floor/plating,
/area/ruin/space/has_grav)
"Zp" = (
/obj/structure/cable{
	icon_state = "0-8"
	},
/obj/structure/cable{
	icon_state = "4-8"
	},
/turf/open/floor/plating,
/area/ruin/space/has_grav)

(1,1,1) = {"
ui
ui
ui
ui
ui
ui
ui
ui
ui
ui
ui
ui
ui
ui
ui
ui
ui
ui
ui
ui
ui
ui
ui
ui
ui
ui
ui
ui
ui
ui
"}
(2,1,1) = {"
ui
ui
ui
ui
ui
ui
ui
ui
ui
ui
ui
ui
ui
ui
ui
ui
ui
ui
ui
ui
JV
ui
ui
ui
ui
ui
ui
ui
ui
ui
"}
(3,1,1) = {"
ui
ui
ui
ui
ui
ui
ui
ui
ui
ui
ui
bQ
ui
ui
ui
ui
ui
NR
NR
NR
Bh
NR
JV
NR
ui
ui
ui
ui
ui
ui
"}
(4,1,1) = {"
ui
ui
ui
ui
ui
ui
ui
ui
ui
ui
ui
bQ
bQ
ui
ui
ui
ui
Zn
Zn
Zn
nt
Np
DG
Zn
ui
ui
ui
ui
ui
ui
"}
(5,1,1) = {"
ui
ui
ui
ui
ui
ui
ui
ui
ui
ui
ui
bQ
bQ
ui
ui
ui
ui
NR
NR
NR
Bh
SM
SM
NR
ui
ui
ui
ui
ui
ui
"}
(6,1,1) = {"
ui
ui
ui
ui
ui
ui
ui
ui
ui
ui
bQ
bQ
bQ
ui
ui
ui
ui
MK
ID
Fv
Ds
Zn
Zn
Zn
ui
ui
ui
ui
ui
ui
"}
(7,1,1) = {"
ui
ui
ui
ui
ui
ui
ui
ui
bQ
bQ
bQ
Pr
bQ
bQ
ui
ui
ui
NR
SM
SM
Bh
NR
NR
NR
ui
ui
ui
ui
ui
ui
"}
(8,1,1) = {"
ui
ui
ui
ui
ui
ui
ui
bQ
bQ
Pr
Pr
Pr
Pr
bQ
ui
ui
ui
ui
ui
VP
mL
VP
ui
ui
ui
ui
ui
ui
ui
ui
"}
(9,1,1) = {"
ui
ui
ui
ui
ui
ui
bQ
bd
VP
VP
VP
VP
Pr
bQ
bQ
ui
ui
ui
bd
VP
ik
VP
mw
ui
ui
ui
ui
ui
ui
ui
"}
(10,1,1) = {"
ui
ui
ui
ui
ui
bQ
bQ
VP
Dx
ca
kt
VP
VP
VP
Nn
ui
ui
ui
VP
oZ
Zp
Br
VP
ui
ui
ui
ui
ui
ui
ui
"}
(11,1,1) = {"
ui
ui
ui
bd
VP
VP
VP
VP
ae
vO
aj
vY
vr
aD
VP
bQ
bQ
ui
VP
Nq
Ut
Zo
VP
ui
ui
ui
ui
ui
ui
ui
"}
(12,1,1) = {"
ui
bQ
bQ
VP
re
FO
vq
VP
VP
Ou
ot
VP
VP
VP
VP
bQ
bQ
bQ
VP
Pb
YY
Gb
VP
ui
ui
ui
ui
ui
ui
ui
"}
(13,1,1) = {"
ui
ui
bQ
ba
dd
FO
cZ
VP
sZ
Hg
PU
EG
ge
Pr
Pr
Pr
Pr
Pr
VP
VP
wX
ot
VP
ui
ui
ui
ui
ui
ui
ui
"}
(14,1,1) = {"
ui
ui
bQ
ba
MV
yK
yK
VP
VP
dn
VP
VP
ot
VP
VP
VP
VP
VP
VP
VP
bv
ot
bQ
bQ
ui
ui
ui
ui
ui
ui
"}
(15,1,1) = {"
ui
ui
ui
ba
Mt
qj
km
RM
FK
ii
WT
Ke
UD
WT
Ke
WT
WT
wY
WT
Ke
TK
NY
sx
iU
ui
ui
ui
ui
ui
ui
"}
(16,1,1) = {"
ui
ui
ui
ba
nQ
yK
cs
VP
VP
VP
VP
Ou
ot
sn
kG
bf
VP
ot
VP
Ou
VP
ot
Pr
bQ
bQ
ui
ui
ui
ui
ui
"}
(17,1,1) = {"
ui
ui
ui
ba
Wd
yK
WK
VP
Pr
Pr
VP
Hg
ot
dH
dZ
DW
wi
bi
YI
wP
pF
MH
Pr
bQ
bQ
ui
ui
ui
ui
ui
"}
(18,1,1) = {"
ui
ui
ui
ba
Cv
hA
lJ
wi
EG
EG
Qz
Hg
ot
rP
mM
kv
VP
MH
rS
Sw
bq
MH
Pr
Pr
bQ
ui
ui
ui
ui
ui
"}
(19,1,1) = {"
ui
ui
ui
VP
zV
yK
cs
VP
Pr
Pr
PU
vT
sE
Qz
VP
VP
VP
zT
EG
EG
EG
RC
Pr
Pr
bQ
ui
ui
ui
ui
ui
"}
(20,1,1) = {"
ui
ui
ui
nS
VP
VP
SN
VP
Xn
Pr
VP
QO
Ad
PU
EG
EG
EG
RC
bQ
bQ
bQ
Pr
Pr
Pr
bQ
bQ
ui
ui
ui
ui
"}
(21,1,1) = {"
ui
ui
ui
ui
VP
CL
Un
VP
bQ
tl
VP
ya
Xs
VP
Pr
Pr
Pr
bQ
ui
ui
ui
bQ
Pr
Pr
Pr
bQ
ui
ui
ui
ui
"}
(22,1,1) = {"
ui
ui
ui
ui
VP
Xk
IV
WV
VP
bQ
VP
dx
Xs
VP
bQ
ui
ui
ui
ui
ui
ui
ui
bQ
Pr
Pr
bQ
ui
ui
ui
ui
"}
(23,1,1) = {"
ui
ui
ui
ui
VP
kM
kM
kM
VP
ui
VP
dx
VP
VP
ui
ui
ui
ui
ui
ui
ui
ui
ui
bQ
bQ
bQ
ui
ui
ui
ui
"}
(24,1,1) = {"
ui
ui
ui
ui
VP
iv
LD
iv
VP
ui
VP
aY
VP
ui
ui
ui
ui
ui
ui
ui
ui
ui
ui
bQ
bQ
bQ
ui
ui
ui
ui
"}
(25,1,1) = {"
ui
ui
ui
ui
nS
VP
VP
VP
UQ
ui
ui
bQ
bQ
ui
ui
ui
ui
ui
ui
ui
ui
ui
ui
ui
ui
bQ
ui
ui
ui
ui
"}
(26,1,1) = {"
ui
ui
ui
ui
ui
ui
ui
ui
ui
ui
ui
ui
bQ
ui
ui
ui
ui
ui
ui
ui
ui
ui
ui
ui
ui
bQ
ui
ui
ui
ui
"}
(27,1,1) = {"
ui
ui
ui
ui
ui
ui
ui
ui
ui
ui
ui
ui
bQ
ui
ui
ui
ui
ui
ui
ui
ui
ui
ui
ui
ui
bQ
ui
ui
ui
ui
"}
(28,1,1) = {"
ui
ui
ui
ui
ui
ui
ui
ui
ui
ui
ui
ui
ui
ui
ui
ui
ui
ui
ui
ui
ui
ui
ui
ui
ui
bQ
ui
ui
ui
ui
"}
(29,1,1) = {"
ui
ui
ui
ui
ui
ui
ui
ui
ui
ui
ui
ui
ui
ui
ui
ui
ui
ui
ui
ui
ui
ui
ui
ui
ui
ui
ui
ui
ui
ui
"}
(30,1,1) = {"
ui
ui
ui
ui
ui
ui
ui
ui
ui
ui
ui
ui
ui
ui
ui
ui
ui
ui
ui
ui
ui
ui
ui
ui
ui
ui
ui
ui
ui
ui
"}
