//MAP CONVERTED BY dmm2tgm.py THIS HEADER COMMENT PREVENTS RECONVERSION, DO NOT REMOVE
"a" = (
/turf/closed/wall/mineral/titanium,
/area/shuttle/custom)
"b" = (
/obj/structure/chair/comfy/shuttle{
	dir = 1
	},
/turf/open/floor/mineral/titanium/white,
/area/shuttle/custom)
"k" = (
/obj/structure/chair/comfy/shuttle,
/turf/open/floor/mineral/titanium/blue,
/area/shuttle/custom)
"m" = (
/obj/structure/chair/comfy/shuttle,
/turf/open/floor/mineral/titanium/white,
/area/shuttle/custom)
"p" = (
/obj/machinery/door/airlock/titanium/glass,
/obj/docking_port/mobile{
	dwidth = 3;
	height = 5;
	id = "smol";
	name = "AI Satellite Access Shuttle";
	port_direction = 4;
	width = 7
	},
/obj/structure/fans/tiny,
/turf/open/floor/mineral/titanium,
/area/shuttle/custom)
"u" = (
/obj/machinery/light/small{
	dir = 1
	},
/turf/open/floor/mineral/titanium/blue,
/area/shuttle/custom)
"w" = (
/obj/structure/closet/crate{
	anchored = 1
	},
/obj/item/storage/firstaid/regular,
/obj/machinery/light/small,
/turf/open/floor/mineral/titanium/white,
/area/shuttle/custom)
"B" = (
/obj/machinery/light/small,
/turf/open/floor/mineral/titanium/blue,
/area/shuttle/custom)
"C" = (
/obj/machinery/computer/shuttle{
	dir = 8;
	name = "AI Access Shuttle Console";
	possible_destinations = "ai_sat;ai_station";
	shuttleId = "smol"
	},
/turf/open/floor/mineral/titanium/blue,
/area/shuttle/custom)
"D" = (
/turf/open/floor/mineral/titanium/white,
/area/shuttle/custom)
"E" = (
/turf/open/floor/mineral/titanium/blue,
/area/shuttle/custom)
"F" = (
/obj/structure/closet/emcloset/anchored,
/obj/structure/closet/emcloset/anchored,
/obj/machinery/light/small{
	dir = 1
	},
/turf/open/floor/mineral/titanium/white,
/area/shuttle/custom)
"J" = (
/obj/effect/spawner/structure/window/shuttle,
/turf/open/floor/plating,
/area/shuttle/custom)
"K" = (
/obj/structure/shuttle/engine/heater{
	dir = 8
	},
/obj/structure/window/reinforced{
	dir = 4
	},
/obj/structure/window/reinforced{
	dir = 1
	},
/obj/structure/window/reinforced,
/turf/open/floor/plating/airless,
/area/shuttle/custom)
"R" = (
/obj/structure/chair/comfy/shuttle{
	dir = 1
	},
/turf/open/floor/mineral/titanium/blue,
/area/shuttle/custom)
"Y" = (
/obj/structure/shuttle/engine/propulsion/burst{
	dir = 8
	},
/turf/open/floor/plating/airless,
/area/shuttle/custom)

(1,1,1) = {"
a
a
Y
a
a
"}
(2,1,1) = {"
a
F
K
w
a
"}
(3,1,1) = {"
J
m
D
b
J
"}
(4,1,1) = {"
J
E
E
E
p
"}
(5,1,1) = {"
J
k
E
R
J
"}
(6,1,1) = {"
a
u
C
B
a
"}
(7,1,1) = {"
a
J
J
J
a
"}
