//MAP CONVERTED BY dmm2tgm.py THIS HEADER COMMENT PREVENTS RECONVERSION, DO NOT REMOVE
"a" = (
/turf/closed/wall/mineral/titanium,
/area/shuttle/arrival)
"g" = (
/obj/docking_port/mobile/arrivals{
	dwidth = 5;
	height = 10;
	name = "Disc arrivals shuttle";
	width = 11
	},
/turf/template_noop,
/area/template_noop)
"h" = (
/turf/template_noop,
/area/template_noop)
"l" = (
/obj/machinery/door/airlock/shuttle{
	name = "Emergency shuttle airlock"
	},
/obj/structure/fans/tiny,
/turf/open/floor/mineral/titanium/tiled/blue,
/area/shuttle/arrival)
"m" = (
/obj/structure/shuttle/engine/propulsion{
	dir = 4
	},
/turf/open/floor/plating,
/area/shuttle/arrival)
"n" = (
/obj/structure/window/reinforced/spawner{
	dir = 4
	},
/obj/structure/chair/comfy/shuttle{
	dir = 8
	},
/obj/machinery/light{
	dir = 1
	},
/turf/open/floor/mineral/titanium/tiled/blue,
/area/shuttle/arrival)
"t" = (
/obj/structure/window/reinforced/spawner{
	dir = 4
	},
/obj/structure/chair/comfy/shuttle{
	dir = 8
	},
/turf/open/floor/mineral/titanium/tiled/blue,
/area/shuttle/arrival)
"w" = (
/obj/structure/window/reinforced/spawner{
	dir = 8
	},
/obj/machinery/atmospherics/components/unary/shuttle/heater{
	dir = 8
	},
/turf/open/floor/plating,
/area/shuttle/arrival)
"y" = (
/obj/structure/window/reinforced/spawner{
	dir = 8
	},
/obj/structure/chair/comfy/shuttle{
	dir = 4
	},
/obj/machinery/light{
	dir = 1
	},
/turf/open/floor/mineral/titanium/tiled/blue,
/area/shuttle/arrival)
"z" = (
/obj/structure/table,
/obj/item/crowbar,
/obj/item/storage/firstaid,
/turf/open/floor/mineral/titanium/tiled/blue,
/area/shuttle/arrival)
"B" = (
/turf/closed/wall/mineral/plastitanium,
/area/shuttle/arrival)
"F" = (
/obj/structure/table,
/obj/item/storage/firstaid/fire,
/turf/open/floor/mineral/titanium/tiled/blue,
/area/shuttle/arrival)
"I" = (
/obj/machinery/requests_console{
	department = "Arrival shuttle";
	name = "Arrivals Shuttle console"
	},
/turf/closed/wall/mineral/titanium,
/area/shuttle/arrival)
"J" = (
/turf/open/floor/mineral/titanium/tiled/blue,
/area/shuttle/arrival)
"M" = (
/obj/structure/closet/wardrobe/green,
/turf/open/floor/mineral/titanium/tiled/blue,
/area/shuttle/arrival)
"Q" = (
/obj/structure/window/reinforced/spawner{
	dir = 8
	},
/obj/structure/chair/comfy/shuttle{
	dir = 4
	},
/obj/machinery/light,
/turf/open/floor/mineral/titanium/tiled/blue,
/area/shuttle/arrival)
"R" = (
/obj/structure/window/reinforced/spawner{
	dir = 4
	},
/obj/structure/chair/comfy/shuttle{
	dir = 8
	},
/obj/machinery/light,
/turf/open/floor/mineral/titanium/tiled/blue,
/area/shuttle/arrival)
"S" = (
/obj/structure/window/reinforced/spawner{
	dir = 8
	},
/obj/structure/chair/comfy/shuttle{
	dir = 4
	},
/turf/open/floor/mineral/titanium/tiled/blue,
/area/shuttle/arrival)
"V" = (
/obj/effect/spawner/structure/window/shuttle,
/turf/open/floor/plating,
/area/shuttle/arrival)

(1,1,1) = {"
a
V
l
V
a
h
a
V
l
V
a
"}
(2,1,1) = {"
a
z
J
J
a
h
a
F
J
M
a
"}
(3,1,1) = {"
a
n
J
R
a
h
I
n
J
R
a
"}
(4,1,1) = {"
a
S
J
S
a
h
a
S
J
S
a
"}
(5,1,1) = {"
V
t
J
t
V
h
V
t
J
t
V
"}
(6,1,1) = {"
a
S
J
S
a
h
a
S
J
S
a
"}
(7,1,1) = {"
a
t
J
t
a
h
a
t
J
t
a
"}
(8,1,1) = {"
a
y
J
Q
a
h
a
y
J
Q
a
"}
(9,1,1) = {"
B
w
V
w
B
h
B
w
V
w
B
"}
(10,1,1) = {"
h
m
h
m
h
g
h
m
h
m
h
"}
