"a" = (/turf/closed/wall/mineral/titanium,/area/shuttle/arrival)
"g" = (/obj/docking_port/mobile/arrivals{dwidth = 5; height = 10; name = "Disc arrivals shuttle"; width = 11},/turf/template_noop,/area/template_noop)
"h" = (/turf/template_noop,/area/template_noop)
"l" = (/obj/machinery/door/airlock/shuttle{name = "Emergency shuttle airlock"},/obj/structure/fans/tiny,/turf/open/floor/mineral/titanium/tiled/blue,/area/shuttle/arrival)
"m" = (/obj/structure/shuttle/engine/propulsion{dir = 4},/turf/open/floor/plating,/area/shuttle/arrival)
"n" = (/obj/structure/window/reinforced/spawner{dir = 4},/obj/structure/chair/comfy/shuttle{dir = 8},/obj/machinery/light{dir = 1},/turf/open/floor/mineral/titanium/tiled/blue,/area/shuttle/arrival)
"t" = (/obj/structure/window/reinforced/spawner{dir = 4},/obj/structure/chair/comfy/shuttle{dir = 8},/turf/open/floor/mineral/titanium/tiled/blue,/area/shuttle/arrival)
"w" = (/obj/structure/window/reinforced/spawner{dir = 8},/obj/machinery/atmospherics/components/unary/shuttle/heater{dir = 8},/turf/open/floor/plating,/area/shuttle/arrival)
"y" = (/obj/structure/window/reinforced/spawner{dir = 8},/obj/structure/chair/comfy/shuttle{dir = 4},/obj/machinery/light{dir = 1},/turf/open/floor/mineral/titanium/tiled/blue,/area/shuttle/arrival)
"z" = (/obj/structure/table,/obj/item/crowbar,/obj/item/storage/firstaid,/turf/open/floor/mineral/titanium/tiled/blue,/area/shuttle/arrival)
"B" = (/turf/closed/wall/mineral/plastitanium,/area/shuttle/arrival)
"F" = (/obj/structure/table,/obj/item/storage/firstaid/fire,/turf/open/floor/mineral/titanium/tiled/blue,/area/shuttle/arrival)
"I" = (/obj/machinery/requests_console{department = "Arrival shuttle"; name = "Arrivals Shuttle console"},/turf/closed/wall/mineral/titanium,/area/shuttle/arrival)
"J" = (/turf/open/floor/mineral/titanium/tiled/blue,/area/shuttle/arrival)
"M" = (/obj/structure/closet/wardrobe/green,/turf/open/floor/mineral/titanium/tiled/blue,/area/shuttle/arrival)
"Q" = (/obj/structure/window/reinforced/spawner{dir = 8},/obj/structure/chair/comfy/shuttle{dir = 4},/obj/machinery/light,/turf/open/floor/mineral/titanium/tiled/blue,/area/shuttle/arrival)
"R" = (/obj/structure/window/reinforced/spawner{dir = 4},/obj/structure/chair/comfy/shuttle{dir = 8},/obj/machinery/light,/turf/open/floor/mineral/titanium/tiled/blue,/area/shuttle/arrival)
"S" = (/obj/structure/window/reinforced/spawner{dir = 8},/obj/structure/chair/comfy/shuttle{dir = 4},/turf/open/floor/mineral/titanium/tiled/blue,/area/shuttle/arrival)
"V" = (/obj/effect/spawner/structure/window/shuttle,/turf/open/floor/plating,/area/shuttle/arrival)

(1,1,1) = {"
aaaaVaaaBh
VznStStywm
lJJJJJJJVh
VJRStStQwm
aaaaVaaaBh
hhhhhhhhhg
aaIaVaaaBh
VFnStStywm
lJJJJJJJVh
VMRStStQwm
aaaaVaaaBh
"}
