//MAP CONVERTED BY dmm2tgm.py THIS HEADER COMMENT PREVENTS RECONVERSION, DO NOT REMOVE
"a" = (
/obj/effect/turf_decal/trimline/brown/filled/line{
	dir = 1
	},
/turf/open/floor/engine/o2,
/area/shuttle/cargo/CargoElevator)
"c" = (
/obj/machinery/computer/shuttle/cargo/elevator{
	dir = 8
	},
/obj/effect/turf_decal/trimline/brown/filled/line{
	dir = 1
	},
/turf/open/floor/engine/o2,
/area/shuttle/cargo/CargoElevator)
"f" = (
/obj/machinery/conveyor{
	dir = 1;
	id = "cargounload"
	},
/obj/effect/turf_decal/trimline/brown/filled/line{
	dir = 4
	},
/turf/open/floor/engine/o2,
/area/shuttle/cargo/CargoElevator)
"h" = (
/turf/open/openspace,
/area/template_noop)
"j" = (
/obj/effect/turf_decal/trimline/brown/filled/line{
	dir = 8
	},
/turf/open/floor/engine/o2,
/area/shuttle/cargo/CargoElevator)
"m" = (
/obj/docking_port/mobile/elevator{
	dir = 4;
	dwidth = 2;
	height = 6;
	id = "cargo_elevator";
	name = "cargo elevator";
	width = 5
	},
/obj/effect/turf_decal/trimline/brown/filled/line{
	dir = 8
	},
/turf/open/floor/engine/o2,
/area/shuttle/cargo/CargoElevator)
"n" = (
/obj/effect/turf_decal/trimline/brown/filled/line{
	dir = 4
	},
/turf/open/floor/engine/o2,
/area/shuttle/cargo/CargoElevator)
"p" = (
/obj/machinery/conveyor{
	dir = 9;
	icon_state = "conveyor_map";
	id = "cargounload"
	},
/obj/effect/turf_decal/trimline/brown/filled/line{
	dir = 4
	},
/turf/open/floor/engine/o2,
/area/shuttle/cargo/CargoElevator)
"r" = (
/turf/open/floor/engine/o2,
/area/shuttle/cargo/CargoElevator)
"s" = (
/obj/effect/turf_decal/trimline/brown/filled/line,
/turf/open/floor/engine/o2,
/area/shuttle/cargo/CargoElevator)

(1,1,1) = {"
h
j
m
j
h
"}
(2,1,1) = {"
a
r
r
r
s
"}
(3,1,1) = {"
a
r
r
r
s
"}
(4,1,1) = {"
a
r
r
r
s
"}
(5,1,1) = {"
c
r
r
r
s
"}
(6,1,1) = {"
h
n
f
p
h
"}
