//MAP CONVERTED BY dmm2tgm.py THIS HEADER COMMENT PREVENTS RECONVERSION, DO NOT REMOVE
"a" = (
/obj/effect/turf_decal/stripes/line{
	dir = 9
	},
/turf/open/floor/engine,
/area/shuttle/cargo/CargoElevator)
"b" = (
/turf/open/floor/engine,
/area/shuttle/cargo/CargoElevator)
"c" = (
/obj/machinery/computer/shuttle/cargo/elevator{
	dir = 8
	},
/obj/effect/turf_decal/stripes/line{
	dir = 5
	},
/turf/open/floor/engine,
/area/shuttle/cargo/CargoElevator)
"f" = (
/obj/machinery/conveyor{
	dir = 1;
	id = "cargounload"
	},
/turf/open/floor/engine,
/area/shuttle/cargo/CargoElevator)
"h" = (
/turf/open/openspace,
/area/template_noop)
"j" = (
/obj/effect/turf_decal/stripes/line{
	dir = 1
	},
/turf/open/floor/engine,
/area/shuttle/cargo/CargoElevator)
"m" = (
/obj/docking_port/mobile/elevator{
	dir = 4;
	dwidth = 2;
	height = 6;
	id = "cargo_elevator";
	name = "cargo elevator";
	width = 5
	},
/turf/open/floor/engine,
/area/shuttle/cargo/CargoElevator)
"p" = (
/obj/machinery/conveyor{
	dir = 9;
	icon_state = "conveyor_map";
	id = "cargounload"
	},
/obj/effect/turf_decal/stripes/line,
/turf/open/floor/engine,
/area/shuttle/cargo/CargoElevator)
"q" = (
/obj/effect/turf_decal/stripes/corner{
	dir = 2
	},
/turf/open/floor/engine,
/area/shuttle/cargo/CargoElevator)
"r" = (
/obj/effect/turf_decal/stripes/corner{
	dir = 1
	},
/turf/open/floor/engine,
/area/shuttle/cargo/CargoElevator)
"s" = (
/obj/effect/turf_decal/stripes/line{
	dir = 10
	},
/turf/open/floor/engine,
/area/shuttle/cargo/CargoElevator)
"u" = (
/obj/effect/turf_decal/stripes/line{
	dir = 6
	},
/turf/open/floor/engine,
/area/shuttle/cargo/CargoElevator)
"E" = (
/obj/effect/turf_decal/stripes/line,
/turf/open/floor/engine,
/area/shuttle/cargo/CargoElevator)
"L" = (
/obj/effect/turf_decal/stripes/corner{
	dir = 8
	},
/turf/open/floor/engine,
/area/shuttle/cargo/CargoElevator)
"T" = (
/obj/effect/turf_decal/stripes/corner{
	dir = 4
	},
/turf/open/floor/engine,
/area/shuttle/cargo/CargoElevator)

(1,1,1) = {"
h
j
m
E
h
"}
(2,1,1) = {"
a
T
b
r
s
"}
(3,1,1) = {"
j
b
b
b
E
"}
(4,1,1) = {"
j
b
b
b
E
"}
(5,1,1) = {"
c
L
b
q
u
"}
(6,1,1) = {"
h
j
f
p
h
"}
