//MAP CONVERTED BY dmm2tgm.py THIS HEADER COMMENT PREVENTS RECONVERSION, DO NOT REMOVE
"a" = (
/obj/effect/turf_decal/tile/brown{
	dir = 4
	},
/obj/effect/turf_decal/tile/brown{
	dir = 1
	},
/obj/machinery/computer/shuttle/cargo/elevator,
/obj/structure/railing{
	dir = 8;
	icon_state = "railing"
	},
/turf/open/floor/plasteel,
/area/shuttle/cargo/CargoElevator)
"b" = (
/obj/effect/turf_decal/tile/brown{
	dir = 4
	},
/obj/effect/turf_decal/tile/brown{
	dir = 1
	},
/turf/open/floor/plasteel,
/area/shuttle/cargo/CargoElevator)
"c" = (
/obj/effect/turf_decal/tile/brown{
	dir = 4
	},
/obj/effect/turf_decal/tile/brown{
	dir = 1
	},
/obj/structure/railing{
	icon_state = "railing";
	dir = 4
	},
/turf/open/floor/plasteel,
/area/shuttle/cargo/CargoElevator)
"d" = (
/obj/effect/turf_decal/tile/brown{
	dir = 8
	},
/obj/effect/turf_decal/tile/brown{
	dir = 1
	},
/obj/structure/railing{
	dir = 1;
	icon_state = "railing"
	},
/turf/open/floor/plasteel,
/area/shuttle/cargo/CargoElevator)
"e" = (
/turf/open/floor/plasteel,
/area/shuttle/cargo/CargoElevator)
"f" = (
/obj/effect/turf_decal/tile/brown,
/obj/effect/turf_decal/tile/brown{
	dir = 4
	},
/obj/machinery/conveyor{
	dir = 1;
	id = "cargounload"
	},
/turf/open/floor/plasteel,
/area/shuttle/cargo/CargoElevator)
"g" = (
/obj/effect/turf_decal/tile/neutral{
	dir = 1
	},
/obj/effect/turf_decal/tile/neutral,
/obj/effect/turf_decal/tile/neutral{
	dir = 4
	},
/obj/effect/turf_decal/tile/neutral{
	dir = 8
	},
/turf/open/floor/plasteel,
/area/shuttle/cargo/CargoElevator)
"h" = (
/turf/open/openspace,
/area/template_noop)
"i" = (
/obj/structure/railing/corner{
	dir = 1;
	icon_state = "railing_corner"
	},
/turf/open/floor/plasteel,
/area/shuttle/cargo/CargoElevator)
"j" = (
/obj/effect/turf_decal/tile/brown{
	dir = 8
	},
/obj/effect/turf_decal/tile/brown{
	dir = 1
	},
/obj/structure/railing,
/turf/open/floor/plasteel,
/area/shuttle/cargo/CargoElevator)
"k" = (
/obj/effect/turf_decal/tile/neutral{
	dir = 1
	},
/obj/effect/turf_decal/tile/neutral,
/obj/effect/turf_decal/tile/neutral{
	dir = 4
	},
/obj/effect/turf_decal/tile/neutral{
	dir = 8
	},
/obj/effect/turf_decal/tile/brown,
/obj/effect/turf_decal/tile/brown{
	dir = 8
	},
/turf/open/floor/plasteel,
/area/shuttle/cargo/CargoElevator)
"l" = (
/obj/structure/railing/corner{
	dir = 4;
	icon_state = "railing_corner"
	},
/turf/open/floor/plasteel,
/area/shuttle/cargo/CargoElevator)
"m" = (
/obj/effect/turf_decal/tile/brown{
	dir = 8
	},
/obj/effect/turf_decal/tile/brown{
	dir = 1
	},
/obj/docking_port/mobile/elevator{
	dir = 4;
	dwidth = 2;
	height = 6;
	id = "cargo_elevator";
	name = "cargo elevator";
	width = 5
	},
/turf/open/floor/plasteel,
/area/shuttle/cargo/CargoElevator)
"n" = (
/obj/effect/turf_decal/tile/brown,
/obj/effect/turf_decal/tile/brown{
	dir = 4
	},
/obj/structure/railing{
	dir = 1;
	icon_state = "railing"
	},
/turf/open/floor/plasteel,
/area/shuttle/cargo/CargoElevator)
"o" = (
/obj/effect/turf_decal/tile/neutral{
	dir = 1
	},
/obj/effect/turf_decal/tile/neutral,
/obj/effect/turf_decal/tile/neutral{
	dir = 4
	},
/obj/effect/turf_decal/tile/neutral{
	dir = 8
	},
/obj/structure/railing/corner,
/turf/open/floor/plasteel,
/area/shuttle/cargo/CargoElevator)
"p" = (
/obj/machinery/conveyor{
	dir = 9;
	icon_state = "conveyor_map";
	id = "cargounload"
	},
/obj/structure/railing,
/turf/open/floor/plasteel,
/area/shuttle/cargo/CargoElevator)
"q" = (
/obj/effect/turf_decal/tile/neutral{
	dir = 1
	},
/obj/effect/turf_decal/tile/neutral,
/obj/effect/turf_decal/tile/neutral{
	dir = 4
	},
/obj/effect/turf_decal/tile/neutral{
	dir = 8
	},
/obj/effect/turf_decal/tile/brown,
/obj/effect/turf_decal/tile/brown{
	dir = 8
	},
/obj/structure/railing{
	icon_state = "railing";
	dir = 4
	},
/turf/open/floor/plasteel,
/area/shuttle/cargo/CargoElevator)
"r" = (
/obj/structure/railing/corner{
	dir = 8;
	icon_state = "railing_corner"
	},
/turf/open/floor/plasteel,
/area/shuttle/cargo/CargoElevator)
"s" = (
/obj/effect/turf_decal/tile/brown,
/obj/effect/turf_decal/tile/brown{
	dir = 8
	},
/obj/structure/railing{
	dir = 8;
	icon_state = "railing"
	},
/turf/open/floor/plasteel,
/area/shuttle/cargo/CargoElevator)

(1,1,1) = {"
h
d
m
j
h
"}
(2,1,1) = {"
a
i
e
r
s
"}
(3,1,1) = {"
b
e
e
g
k
"}
(4,1,1) = {"
b
e
e
g
k
"}
(5,1,1) = {"
c
l
e
o
q
"}
(6,1,1) = {"
h
n
f
p
h
"}
